ID,degree,in_degree,out_degree,betweenness,eigenvector,date
9512380,4,3,1,4.513555747141569e-05,6.501142554201573e-05,1995-12-15
9503492,131,114,17,0.0004591246392904549,0.00016254832690003042,1995-04-01
12308,1,0,1,0.0,8.211974124807393e-20,2000-12-22
9908520,32,14,18,0.00013671285652114686,6.500995355792976e-05,1999-08-31
9910236,1,0,1,0.0,8.211974124807393e-20,1999-10-05
9908395,100,39,61,0.0004708715019584243,3.6337360234350806e-10,1999-08-18
9711261,1,0,1,0.0,8.211974124807393e-20,1997-11-07
106315,1,0,1,0.0,8.211974124807393e-20,2001-06-28
9807423,134,116,18,0.00031581930217590827,3.250497681815725e-05,1998-07-20
9509316,1,0,1,0.0,8.211974124807393e-20,1995-09-18
9406430,67,52,15,0.00014024353418501352,3.1395452847748903e-13,1994-06-30
109097,40,15,25,3.645003487539337e-05,5.304935284625612e-17,2001-09-12
9901427,46,3,43,3.7810836177408055e-05,1.0675566362249613e-17,1999-01-27
9602234,2,1,1,1.231201178013287e-06,7.7767394961926e-17,1996-02-06
3058,2,0,2,0.0,8.211974124807393e-20,2000-03-07
9811265,52,37,15,0.00014175013562652979,1.2776827413764864e-12,1998-11-06
9905340,20,8,12,2.021761934421819e-05,2.833131073058542e-17,1999-05-14
9904210,2,1,1,0.0,4.485380266969801e-16,1999-04-01
9904279,1,0,1,0.0,8.211974124807393e-20,1999-04-08
9902364,1,0,1,0.0,8.211974124807393e-20,1999-02-16
9212278,3,3,0,0.0,9.035344918360012e-12,1992-12-17
9310320,2,2,0,0.0,8.637702243696351e-12,1993-10-20
9403338,3,3,0,0.0,8.638373161982348e-12,1994-03-22
9505402,1,1,0,0.0,8.637253787789394e-12,1995-05-29
9601243,2,2,0,0.0,8.637702243696351e-12,1996-01-11
9607250,1,1,0,0.0,8.637253787789394e-12,1996-07-05
9706212,1,1,0,0.0,8.637253787789394e-12,1997-06-02
9706428,1,1,0,0.0,8.637253787789394e-12,1997-06-20
9712381,1,1,0,0.0,8.637253787789394e-12,1997-12-15
9806387,3,3,0,0.0,8.722414505175627e-12,1998-06-16
9807235,2,2,0,0.0,8.637702243696351e-12,1998-07-03
9807310,2,2,0,0.0,8.637702243696351e-12,1998-07-09
9807315,1,1,0,0.0,8.637253787789394e-12,1998-07-09
9808333,2,2,0,0.0,8.637702243696351e-12,1998-08-14
9808355,2,2,0,0.0,8.637702243696351e-12,1998-08-18
9812475,2,1,1,0.0,4.485380266969801e-16,1998-12-22
9806376,1,0,1,0.0,8.211974124807393e-20,1998-06-16
9802287,50,31,19,0.0001232497179253301,9.566949855400645e-14,1998-02-10
9806294,1,0,1,0.0,8.211974124807393e-20,1998-06-07
9710273,15,4,11,4.276804092046155e-06,1.4206715235916795e-17,1997-10-07
9902283,2,1,1,0.0,4.485380266969801e-16,1999-02-09
9808205,1,0,1,0.0,8.211974124807393e-20,1998-08-03
9803415,1,0,1,0.0,8.211974124807393e-20,1998-03-21
9808270,1,0,1,0.0,8.211974124807393e-20,1998-08-09
9901243,2,1,1,0.0,4.485380266969801e-16,1999-01-07
112089,1,0,1,0.0,8.211974124807393e-20,2000-02-03
112089,1,0,1,0.0,8.211974124807393e-20,2000-02-25
112089,1,0,1,0.0,8.211974124807393e-20,2000-02-10
112089,1,0,1,0.0,8.211974124807393e-20,2001-12-06
111392,23,5,18,2.0995220088226582e-05,9.189199045659477e-17,2001-11-29
4173,2,1,1,4.86000465005245e-06,7.7767394961926e-17,2000-04-18
9902482,58,34,24,8.339767979490003e-05,1.207735034535422e-15,1999-02-26
7319,1,0,1,0.0,8.211974124807393e-20,2000-07-27
9912264,1,0,1,0.0,8.211974124807393e-20,1999-12-07
9905520,2,0,2,0.0,8.211974124807393e-20,1999-05-27
9902315,36,17,19,5.452925217358848e-05,6.011165059359058e-17,1999-02-11
9809423,2,1,1,3.061802929533043e-06,1.387823627092449e-15,1998-09-17
9811239,2,1,1,3.061802929533043e-06,1.387823627092449e-15,1998-11-04
6346,1,0,1,0.0,8.211974124807393e-20,2000-06-29
101168,1,0,1,0.0,8.211974124807393e-20,2001-01-16
10234,20,7,13,8.748008370094409e-06,2.8893315319108397e-06,2000-10-20
2209,1,0,1,0.0,8.211974124807393e-20,2000-02-18
9902419,49,11,38,4.062963887443848e-05,3.892475735158702e-17,1999-02-22
1104,1,0,1,0.0,8.211974124807393e-20,2000-01-12
9906513,2,1,1,0.0,2.2607564765594756e-16,1999-06-25
9905487,56,44,12,5.287685059257065e-05,2.889331531902294e-05,1999-05-26
9906523,1,0,1,0.0,8.211974124807393e-20,1999-06-28
9604412,1,0,1,0.0,8.211974124807393e-20,1996-04-26
9910506,1,0,1,0.0,8.211974124807393e-20,1999-10-27
9609463,1,0,1,0.0,8.211974124807393e-20,1996-09-25
9512229,70,17,53,0.0002230418134064071,1.7511049384256772e-14,1995-12-04
9812472,1,0,1,0.0,8.211974124807393e-20,1998-12-22
9210242,3,3,0,0.0,3.250496125392031e-05,1992-10-16
9212305,2,2,0,0.0,3.250496125369431e-05,1992-12-22
9303202,3,3,0,0.0,6.500994043743272e-05,1993-03-01
9303309,4,4,0,0.0,3.2504961267963685e-05,1993-03-26
9401219,5,5,0,0.0,3.250496126811552e-05,1994-01-07
9407389,5,5,0,0.0,3.250496126856045e-05,1994-07-27
9409375,2,2,0,0.0,3.2504961091222624e-05,1994-09-21
9503443,1,1,0,0.0,3.250496107710509e-05,1995-03-27
9504316,4,4,0,0.0,9.75148830626925e-05,1995-04-17
9508343,5,5,0,0.0,0.00011629553790110233,1995-08-22
9603350,1,1,0,0.0,3.250496107710509e-05,1996-03-19
9606211,3,3,0,0.0,6.500994043735856e-05,1996-06-03
9609331,1,1,0,0.0,3.250496107710509e-05,1996-09-12
9612363,1,1,0,0.0,3.250496107710509e-05,1996-12-14
9710434,1,1,0,0.0,3.250496107710509e-05,1997-10-22
9710438,1,1,0,0.0,3.250496107710509e-05,1997-10-22
9803277,2,2,0,0.0,3.250496107733108e-05,1998-03-08
9805349,2,2,0,0.0,3.250496107733108e-05,1998-05-18
9711446,1,0,1,0.0,8.211974124807393e-20,1997-11-24
9607414,79,47,32,0.0003499041347882763,6.500995361430452e-05,1996-07-24
9307201,3,3,0,0.0,6.500992216195072e-05,1993-07-01
9311248,1,1,0,0.0,6.500992197124398e-05,1993-11-09
9311269,1,1,0,0.0,6.500992197124398e-05,1993-11-10
9312272,2,2,0,0.0,6.500992214783319e-05,1993-12-13
9408228,2,2,0,0.0,6.500992207239373e-05,1994-08-03
9410404,2,2,0,0.0,6.500992197240925e-05,1994-10-28
9411203,2,2,0,0.0,6.500992207239373e-05,1994-11-01
9501222,2,2,0,0.0,6.500992207239373e-05,1995-01-05
9502317,1,1,0,0.0,6.500992197124398e-05,1995-02-16
9503362,1,1,0,0.0,6.500992197124398e-05,1995-03-17
9505207,2,2,0,0.0,6.500992207239373e-05,1995-05-01
9505245,2,2,0,0.0,6.500992197240925e-05,1995-05-06
9505304,1,1,0,0.0,6.500992197124398e-05,1995-05-15
9506251,1,1,0,0.0,6.500992197124398e-05,1995-06-06
9508237,1,1,0,0.0,6.500992197124398e-05,1995-08-04
9510372,2,2,0,0.0,6.500992207239373e-05,1995-10-23
9511324,1,1,0,0.0,6.500992197124398e-05,1995-11-15
9512288,1,1,0,0.0,6.500992197124398e-05,1995-12-12
9512446,1,1,0,0.0,6.500992197124398e-05,1995-12-31
9601367,3,3,0,0.0,6.50099220731388e-05,1996-01-29
9602239,3,3,0,0.0,6.50099220731388e-05,1996-02-07
9602267,1,1,0,0.0,6.500992197124398e-05,1996-02-09
9603310,1,1,0,0.0,6.500992197124398e-05,1996-03-14
9603336,2,2,0,0.0,6.500992207239373e-05,1996-03-18
9604452,2,2,0,0.0,6.500992197198904e-05,1996-04-30
9605351,2,2,0,0.0,6.500992207239373e-05,1996-05-19
9605398,2,2,0,0.0,6.500992197198904e-05,1996-05-25
9606408,1,1,0,0.0,6.500992197124398e-05,1996-06-21
9607220,1,1,0,0.0,6.500992197124398e-05,1996-07-02
9607234,1,1,0,0.0,6.500992197124398e-05,1996-07-04
9706307,1,0,1,0.0,8.211974124807393e-20,1997-06-09
9701342,1,0,1,0.0,8.211974124807393e-20,1997-01-21
101165,1,0,1,0.0,8.211974124807393e-20,2001-01-15
2258,2,0,2,0.0,8.211974124807393e-20,2000-02-24
9905536,1,0,1,0.0,8.211974124807393e-20,1999-05-28
9903476,1,0,1,0.0,8.211974124807393e-20,1999-03-24
9605451,1,0,1,0.0,8.211974124807393e-20,1996-05-31
9507228,1,0,1,0.0,8.211974124807393e-20,1995-07-05
9207214,4,4,0,0.0,0.00016260014789697583,1992-07-03
9307291,1,1,0,0.0,0.0001626001478937766,1993-07-18
9308287,1,1,0,0.0,0.0001626001478937766,1993-08-17
9311243,1,1,0,0.0,0.0001626001478937766,1993-11-09
9311339,2,2,0,0.0,0.0001626001478951149,1993-11-23
9402360,2,2,0,0.0,0.00016260014789504075,1994-02-27
9402364,1,1,0,0.0,0.0001626001478937766,1994-02-28
9403407,1,1,0,0.0,0.0001626001478937766,1994-03-31
9405204,1,1,0,0.0,0.0001626001478937766,1994-05-02
9405207,1,1,0,0.0,0.0001626001478937766,1994-05-03
9405304,1,1,0,0.0,0.0001626001478937766,1994-05-16
9408290,1,1,0,0.0,0.0001626001478937766,1994-08-15
9408306,2,2,0,0.0,0.0001626001478951149,1994-08-16
9408376,3,3,0,0.0,0.0001626001478942286,1994-08-26
9409287,1,1,0,0.0,0.0001626001478937766,1994-09-12
9409453,1,1,0,0.0,0.0001626001478937766,1994-09-30
9410387,1,1,0,0.0,0.0001626001478937766,1994-10-26
103065,1,0,1,0.0,8.211974124807393e-20,2001-03-06
5159,89,14,75,0.0008173305877361915,3.250497969697925e-05,2000-05-17
9911272,1,0,1,0.0,8.211974124807393e-20,1999-11-08
9904504,77,38,39,0.0002829656707415538,1.3426577694060111e-16,1999-04-30
2117,1,1,0,0.0,3.250497936010171e-05,2000-02-10
2141,1,1,0,0.0,3.250497936010171e-05,2000-02-14
2208,2,1,1,4.761230841259954e-05,3.250497936010171e-05,2000-02-18
2245,1,1,0,0.0,3.250497936010171e-05,2000-02-24
4028,1,1,0,0.0,3.250497936010171e-05,2000-04-04
5027,1,1,0,0.0,3.250497936010171e-05,2000-05-03
5303,1,1,0,0.0,3.250497936010171e-05,2000-05-30
7328,2,1,1,4.761230841259954e-05,3.250497936010171e-05,2000-07-28
8183,2,1,1,0.0,3.250497936010171e-05,2000-08-17
10348,1,1,0,0.0,3.250497936010171e-05,2000-10-31
9209232,1,1,0,0.0,3.250497936010171e-05,1992-09-14
9210235,4,4,0,0.0,3.250497953699461e-05,1992-10-14
9211256,2,2,0,0.0,3.2504979536690935e-05,1992-11-17
9303270,2,2,0,0.0,3.2504979360327705e-05,1993-03-17
9306205,3,3,0,0.0,3.250497953691694e-05,1993-06-01
9306309,3,3,0,0.0,3.250497975797038e-05,1993-06-23
9308335,2,2,0,0.0,3.2504979536690935e-05,1993-08-25
9310212,2,2,0,0.0,3.2504979536690935e-05,1993-10-04
9311222,3,3,0,0.0,3.250497953691694e-05,1993-11-04
9311228,2,2,0,0.0,3.2504979536690935e-05,1993-11-04
9311340,1,1,0,0.0,3.250497936010171e-05,1993-11-22
9401241,1,1,0,0.0,3.250497936010171e-05,1994-01-12
9402253,2,2,0,0.0,3.2504979360327705e-05,1994-02-09
9403306,2,2,0,0.0,3.2504979536690935e-05,1994-03-17
9403330,1,1,0,0.0,3.250497936010171e-05,1994-03-22
9403397,2,2,0,0.0,3.2504979536690935e-05,1994-03-30
9406389,2,2,0,0.0,3.250497936084679e-05,1994-06-24
9408213,2,2,0,0.0,3.2504979360698475e-05,1993-08-02
9408406,2,2,0,0.0,3.250497975774438e-05,1994-08-31
9410231,1,1,0,0.0,3.250497936010171e-05,1994-10-06
9412379,2,2,0,0.0,3.2504979360327705e-05,1994-12-28
9501277,2,2,0,0.0,3.2504979360327705e-05,1995-01-11
9501334,2,2,0,0.0,3.250497975774438e-05,1995-01-18
9501407,2,2,0,0.0,3.2504979360105247e-05,1995-01-31
9502252,2,2,0,0.0,3.2504979536690935e-05,1995-02-08
9503358,2,2,0,0.0,3.2504979360327705e-05,1995-03-16
9503388,1,1,0,0.0,3.250497936010171e-05,1995-03-21
9504373,2,2,0,0.0,3.250497975774438e-05,1995-04-24
9505428,1,1,0,0.0,3.250497936010171e-05,1995-05-31
9507379,1,1,0,0.0,3.250497936010171e-05,1995-07-21
9510286,1,1,0,0.0,3.250497936010171e-05,1995-10-13
9510309,2,2,0,0.0,3.2504979360105247e-05,1995-10-16
9510327,1,1,0,0.0,3.250497936010171e-05,1995-10-17
9601360,2,2,0,0.0,3.250498971508632e-05,1996-01-29
9602206,1,1,0,0.0,3.250497936010171e-05,1996-02-01
9604387,5,5,0,0.0,3.250674669532475e-05,1996-04-23
9605296,2,2,0,0.0,3.2504979360105247e-05,1996-05-14
9609512,1,1,0,0.0,3.250497936010171e-05,1996-09-29
9610224,1,1,0,0.0,3.250497936010171e-05,1996-10-02
9610323,1,1,0,0.0,3.250497936010171e-05,1996-10-10
9703358,2,2,0,0.0,3.25049793601794e-05,1997-03-18
9704376,4,3,1,0.00012965798119961354,9.75164049015206e-05,1997-04-22
9707401,1,1,0,0.0,3.250497936010171e-05,1997-07-20
9709356,3,2,1,9.63900922260402e-05,3.2504979360253545e-05,1997-09-15
9710312,1,1,0,0.0,3.250497936010171e-05,1997-10-10
9711348,2,2,0,0.0,3.2504979360105247e-05,1997-11-17
9712305,2,2,0,0.0,3.250497936084679e-05,1997-12-08
9802391,1,1,0,0.0,3.250497936010171e-05,1998-02-23
9803259,2,1,1,8.705888329793949e-05,3.250497936010171e-05,1998-03-06
9804294,1,1,0,0.0,3.250497936010171e-05,1998-04-15
9805367,2,2,0,0.0,3.2504979360105247e-05,1998-05-19
9806308,1,1,0,0.0,3.250497936010171e-05,1998-06-08
9808312,1,1,0,0.0,3.250497936010171e-05,1998-08-13
9808328,1,1,0,0.0,3.250497936010171e-05,1998-08-14
9810479,2,2,0,0.0,3.2504979360105247e-05,1998-10-26
9904219,1,1,0,0.0,3.250497936010171e-05,1999-04-02
9906362,1,1,0,0.0,3.250497936010171e-05,1999-06-15
9907211,1,1,0,0.0,3.250497936010171e-05,1999-07-01
9911245,1,1,0,0.0,3.250497936010171e-05,1999-11-04
9911370,2,2,0,0.0,3.250497956615485e-05,1999-11-16
9911459,1,1,0,0.0,3.250497936010171e-05,1999-11-23
9912249,2,1,1,6.80886651472348e-05,3.250497936010171e-05,1999-12-06
9912317,1,1,0,0.0,3.250497936010171e-05,1999-12-13
12333,1,0,1,0.0,8.211974124807393e-20,2000-12-25
102098,1,0,1,0.0,8.211974124807393e-20,2001-02-08
12377,26,12,14,3.648243490639372e-05,1.8780654947087998e-05,2000-12-29
102331,4,2,2,1.7964209564015148e-05,1.034768687136841e-13,2001-02-27
102243,37,20,17,5.424218517623369e-05,0.32444265970653824,2001-02-19
9812320,1,0,1,0.0,8.211974124807393e-20,1998-12-10
111064,1,0,1,0.0,8.211974124807393e-20,2000-01-31
111064,1,0,1,0.0,8.211974124807393e-20,2001-11-06
9705337,1,0,1,0.0,8.211974124807393e-20,1997-05-16
9504378,3,2,1,2.2161621204239168e-05,1.4195300591883376e-14,1995-04-24
9705221,1,0,1,0.0,8.211974124807393e-20,1997-05-02
9907520,1,0,1,0.0,8.211974124807393e-20,1999-07-27
4129,1,0,1,0.0,8.211974124807393e-20,2000-04-13
109287,71,46,25,0.00011168290685820529,1.6974822749976306e-05,2001-09-28
112247,1,0,1,0.0,8.211974124807393e-20,2001-12-19
110127,1,0,1,0.0,8.211974124807393e-20,2001-10-10
112161,1,0,1,0.0,8.211974124807393e-20,2000-02-21
112161,1,0,1,0.0,8.211974124807393e-20,2001-12-11
1031,1,1,0,0.0,1.6974822749972637e-05,2000-01-05
2257,1,1,0,0.0,1.6974822749972637e-05,2000-02-24
8153,1,1,0,0.0,1.6974822749972637e-05,2000-08-15
11097,1,1,0,0.0,1.6974822749972637e-05,2000-11-07
102065,1,1,0,0.0,1.6974822749972637e-05,2001-02-06
103043,1,1,0,0.0,1.6974822749972637e-05,2001-03-04
106219,1,1,0,0.0,1.6974822749972637e-05,2001-06-19
106295,1,1,0,0.0,1.6974822749972637e-05,2001-06-27
107119,1,1,0,0.0,1.6974822749972637e-05,2001-07-10
108060,1,1,0,0.0,1.6974822749972637e-05,2001-08-06
109106,1,1,0,0.0,1.6974822749972637e-05,2001-09-12
109184,1,1,0,0.0,1.6974822749972637e-05,2001-09-20
109202,1,1,0,0.0,1.6974822749972637e-05,2001-09-21
109242,2,1,1,0.0,1.6974822749972637e-05,2001-09-26
9512364,1,1,0,0.0,1.6974822749972637e-05,1995-12-19
9710431,1,1,0,0.0,1.6974822749972637e-05,1997-10-22
9711438,1,1,0,0.0,1.6974822749972637e-05,1997-11-24
9803315,6,6,0,0.0,4.586814320810485e-05,1998-03-11
9804398,4,4,0,0.0,4.5868143205205766e-05,1998-04-24
9807264,1,1,0,0.0,1.6974822749972637e-05,1998-07-06
9807344,4,4,0,0.0,1.6974822855751734e-05,1998-07-12
9811291,2,2,0,0.0,1.6974822752794026e-05,1998-11-10
9811323,1,1,0,0.0,1.6974822749972637e-05,1998-11-13
9812260,1,1,0,0.0,1.6974822749972637e-05,1998-12-05
9905221,3,3,0,0.0,4.5868138169988744e-05,1999-05-04
111042,1,0,1,0.0,8.211974124807393e-20,2001-11-05
9909255,1,0,1,0.0,8.211974124807393e-20,1999-09-06
201139,1,0,1,0.0,8.211974124807393e-20,2002-01-15
6041,1,0,1,0.0,8.211974124807393e-20,2000-06-05
202081,1,0,1,0.0,8.211974124807393e-20,2002-02-08
202124,1,0,1,0.0,8.211974124807393e-20,2002-02-14
201228,1,0,1,0.0,8.211974124807393e-20,2002-01-23
8333,2,0,2,0.0,8.211974124807393e-20,2000-08-31
9911540,14,1,13,2.0250019375218543e-06,3.613268614915252e-18,1999-11-30
9912464,1,0,1,0.0,8.211974124807393e-20,1999-12-22
9810320,1,1,0,0.0,2.8893315317284476e-05,1998-10-11
9812483,1,1,0,0.0,2.8893315317284476e-05,1998-12-22
9902381,1,1,0,0.0,2.8893315317284476e-05,1999-02-17
9903224,1,1,0,0.0,2.8893315317284476e-05,1999-03-02
9903319,1,1,0,0.0,2.8893315317284476e-05,1999-03-11
9903524,1,1,0,0.0,2.8893315317284476e-05,1999-03-30
9904485,1,1,0,0.0,2.8893315317284476e-05,1999-04-29
9904495,2,1,1,0.0,2.8893315317284476e-05,1999-04-29
9905244,1,1,0,0.0,2.8893315317284476e-05,1999-05-04
9909481,1,0,1,0.0,8.211974124807393e-20,1999-09-22
9910498,2,1,1,0.0,2.2607564765594756e-16,1999-10-26
3089,1,0,1,0.0,8.211974124807393e-20,2000-03-09
9906542,1,0,1,0.0,8.211974124807393e-20,1999-06-29
103324,2,1,1,0.0002641014469779787,2.0605321234484194e-13,2001-03-29
11200,41,9,32,0.0003652867437920707,1.619582699920434e-12,2000-11-16
9910277,1,0,1,0.0,8.211974124807393e-20,1999-10-08
9909490,1,0,1,0.0,8.211974124807393e-20,1999-09-23
8127,1,0,1,0.0,8.211974124807393e-20,2000-08-14
9603368,1,0,1,0.0,8.211974124807393e-20,1996-03-20
9511344,1,0,1,0.0,8.211974124807393e-20,1995-11-16
9704448,1,0,1,0.0,8.211974124807393e-20,1997-04-30
103197,1,0,1,0.0,8.211974124807393e-20,2001-03-19
101336,3,0,3,0.0,8.211974124807393e-20,2001-01-30
12154,22,8,14,2.2543478712457577e-05,2.833131073058542e-17,2000-12-13
9910257,43,8,35,9.135605312375738e-05,5.536822373918183e-11,1999-10-06
9254,1,0,1,0.0,8.211974124807393e-20,2000-09-21
7315,43,29,14,9.175688779299024e-05,9.297597104106899e-15,2000-07-27
9608276,2,1,1,3.3825632364365045e-06,7.451545320850212e-16,1996-08-08
103326,1,0,1,0.0,8.211974124807393e-20,2001-03-29
9509432,1,0,1,0.0,8.211974124807393e-20,1995-10-01
9704351,1,0,1,0.0,8.211974124807393e-20,1997-04-18
9612313,1,0,1,0.0,8.211974124807393e-20,1996-12-10
9710217,1,0,1,0.0,8.211974124807393e-20,1997-10-02
9707239,39,10,29,4.131003952544582e-05,3.53936084779198e-17,1997-07-03
9804436,1,0,1,0.0,8.211974124807393e-20,1998-04-28
9707515,51,32,19,0.00012188891662331543,7.604153363196021e-13,1997-07-30
9255,1,0,1,0.0,8.211974124807393e-20,2000-09-21
9903404,1,0,1,0.0,8.211974124807393e-20,1999-03-18
9907507,2,1,1,0.0,1.519215213089368e-16,1999-07-27
9802416,1,0,1,0.0,8.211974124807393e-20,1998-02-25
9711481,27,15,12,3.3728432271364e-05,1.6638855612461014e-14,1997-11-26
9611217,1,0,1,0.0,8.211974124807393e-20,1996-11-03
9611243,1,0,1,0.0,8.211974124807393e-20,1996-11-05
101263,1,0,1,0.0,8.211974124807393e-20,2001-01-23
9203223,3,3,0,0.0,2.4705048309012507e-12,1992-03-29
9206246,2,2,0,0.0,2.470501299752377e-12,1992-06-23
9206262,2,2,0,0.0,2.470501299752377e-12,1992-06-29
9207212,2,2,0,0.0,2.470501299752377e-12,1992-07-03
9302281,1,1,0,0.0,2.456383766555455e-12,1993-02-19
9303226,2,2,0,0.0,2.470501299752377e-12,1993-03-05
9303277,1,1,0,0.0,2.456383766555455e-12,1993-03-18
9305279,2,2,0,0.0,2.456461451830675e-12,1993-05-17
9305335,1,1,0,0.0,2.456383766555455e-12,1993-05-27
9306270,3,3,0,0.0,2.6470905237755987e-12,1993-06-14
9306271,2,2,0,0.0,2.470501299752377e-12,1993-06-14
9307259,2,2,0,0.0,2.470501299752377e-12,1993-07-13
9308330,2,2,0,0.0,2.470501299752377e-12,1993-08-24
9310281,1,1,0,0.0,2.456383766555455e-12,1993-10-13
9311372,2,2,0,0.0,2.470501299752377e-12,1993-11-29
1002,1,0,1,0.0,8.211974124807393e-20,2000-01-01
110189,1,0,1,0.0,8.211974124807393e-20,2001-10-15
1124,1,0,1,0.0,8.211974124807393e-20,2000-01-14
9809424,1,0,1,0.0,8.211974124807393e-20,1998-09-17
9211214,1,1,0,0.0,9.589894932302743e-13,1992-11-05
9211328,1,1,0,0.0,9.589894932302743e-13,1992-11-28
9411219,1,1,0,0.0,9.589894932302743e-13,1994-11-03
9411274,1,1,0,0.0,9.589894932302743e-13,1994-11-11
9504287,1,1,0,0.0,9.589894932302743e-13,1995-04-11
9505425,1,1,0,0.0,9.589894932302743e-13,1995-05-30
9603335,1,1,0,0.0,9.589894932302743e-13,1996-03-18
9611423,1,1,0,0.0,9.589894932302743e-13,1996-11-25
9702243,1,1,0,0.0,9.589894932302743e-13,1997-02-04
9702429,2,2,0,0.0,9.59512103263577e-13,1997-02-27
9703240,1,1,0,0.0,9.589894932302743e-13,1997-03-05
9703454,1,1,0,0.0,9.589894932302743e-13,1997-03-29
9709438,1,1,0,0.0,9.589894932302743e-13,1997-09-24
9709483,2,2,0,0.0,9.59512103263577e-13,1997-09-29
9710403,1,1,0,0.0,9.589894932302743e-13,1997-10-20
9711421,1,1,0,0.0,9.589894932302743e-13,1997-11-21
9712291,1,1,0,0.0,9.589894932302743e-13,1997-12-08
9712409,1,1,0,0.0,9.589894932302743e-13,1997-12-17
9801431,2,2,0,0.0,9.59512103263577e-13,1998-01-29
9906450,1,0,1,0.0,8.211974124807393e-20,1999-06-22
9905395,1,0,1,0.0,8.211974124807393e-20,1999-05-19
109238,1,0,1,0.0,8.211974124807393e-20,2001-09-25
3119,1,0,1,0.0,8.211974124807393e-20,2000-03-13
7018,1,0,1,0.0,8.211974124807393e-20,2000-07-03
9908369,1,0,1,0.0,8.211974124807393e-20,1999-08-16
106280,2,0,2,0.0,8.211974124807393e-20,2001-06-25
104317,65,18,47,0.0007252176164245025,2.0480745587010865e-14,2001-04-30
9812427,29,15,14,2.0412019530220286e-05,5.304935284625612e-17,1998-12-18
9912391,2,1,1,4.131003952544582e-06,3.002297740029582e-16,1999-12-17
108159,1,0,1,0.0,8.211974124807393e-20,2001-08-20
103311,17,5,12,5.832005580062939e-06,1.773786410958398e-17,2001-03-29
9301236,1,1,0,0.0,3.7438390034996924e-16,1993-01-13
9403301,1,1,0,0.0,3.7438390034996924e-16,1994-03-17
9407241,1,1,0,0.0,3.7438390034996924e-16,1994-07-06
9411342,1,1,0,0.0,3.7438390034996924e-16,1994-11-19
9502209,1,1,0,0.0,3.7438390034996924e-16,1995-02-01
9504408,1,1,0,0.0,3.7438390034996924e-16,1995-04-27
9701393,1,1,0,0.0,3.7438390034996924e-16,1997-01-27
9707489,1,1,0,0.0,3.7438390034996924e-16,1997-07-28
9710436,1,1,0,0.0,3.7438390034996924e-16,1997-10-22
9803367,1,1,0,0.0,3.7438390034996924e-16,1998-03-17
9809334,1,1,0,0.0,3.7438390034996924e-16,1998-09-11
9904270,1,1,0,0.0,3.7438390034996924e-16,1999-04-08
9901224,1,0,1,0.0,8.211974124807393e-20,1999-01-05
9807354,33,18,15,2.6244025110283225e-05,6.364279946725773e-17,1998-07-13
9207236,2,2,0,0.0,2.602538839633966e-15,1992-07-14
9308246,2,2,0,0.0,1.300883457033114e-14,1993-08-08
9311215,1,1,0,0.0,1.338387542861113e-15,1993-11-02
9401226,2,2,0,0.0,1.935151702510865e-15,1994-01-10
9406339,1,1,0,0.0,1.338387542861113e-15,1994-06-15
9406359,2,2,0,0.0,2.8250012186750006e-15,1994-06-22
9409440,1,1,0,0.0,1.338387542861113e-15,1994-09-29
9502251,1,1,0,0.0,1.338387542861113e-15,1995-02-08
9502338,1,1,0,0.0,1.338387542861113e-15,1995-02-17
9601249,1,1,0,0.0,1.338387542861113e-15,1996-01-11
9607314,1,1,0,0.0,1.338387542861113e-15,1996-07-15
9710339,1,1,0,0.0,1.338387542861113e-15,1997-10-14
9905295,1,0,1,0.0,8.211974124807393e-20,1999-05-11
9602238,107,40,67,0.00028661067422909315,1.2289219277774271e-15,1996-02-06
9909567,1,0,1,0.0,8.211974124807393e-20,1999-09-30
9909480,2,1,1,9.68342040795379e-05,1.0354984688533647e-11,1999-09-22
12096,1,0,1,0.0,8.211974124807393e-20,2000-12-08
9212,1,0,1,0.0,8.211974124807393e-20,2000-09-18
109125,2,1,1,3.1104029760335674e-05,6.197174485260025e-14,2001-09-14
104146,3,2,1,0.0004653852509948937,3.087849265264409e-13,2001-04-16
7226,1,0,1,0.0,8.211974124807393e-20,2000-07-20
9806471,4,3,1,2.5744138917706405e-05,1.7567741889091787e-09,1998-06-24
9309266,1,1,0,0.0,5.968462793910005e-16,1993-09-15
9309310,1,1,0,0.0,5.968462793910005e-16,1993-09-21
9312341,1,1,0,0.0,5.968462793910005e-16,1993-12-27
9510367,1,1,0,0.0,5.968462793910005e-16,1995-10-22
9807327,2,2,0,0.0,1.3419186917347733e-15,1998-07-10
9808292,2,2,0,0.0,1.3419186917347733e-15,1998-08-11
9810536,1,1,0,0.0,5.968462793910005e-16,1998-10-30
9811267,1,1,0,0.0,5.968462793910005e-16,1998-11-06
9811498,1,1,0,0.0,5.968462793910005e-16,1998-11-28
9901208,3,2,1,7.11828681077682e-05,3.4182342294510814e-15,1999-01-03
9901406,1,1,0,0.0,5.968462793910005e-16,1999-01-25
9903250,1,1,0,0.0,5.968462793910005e-16,1999-03-03
202200,1,0,1,0.0,8.211974124807393e-20,2002-02-21
111158,27,6,21,3.0326429016327283e-05,2.1269012983251138e-17,2001-11-13
9703290,2,1,1,4.9766447616537095e-06,1.2642334165141024e-15,1997-03-10
9706311,1,0,1,0.0,8.211974124807393e-20,1997-06-10
202031,1,0,1,0.0,8.211974124807393e-20,2002-02-05
9806400,1,0,1,0.0,8.211974124807393e-20,1998-06-18
9803440,2,1,1,1.3219212648142662e-05,5.226921530439902e-16,1998-03-24
9804310,2,1,1,1.87920179802028e-05,2.154082932678228e-15,1998-04-17
9303230,3,3,0,0.0,5.344521023774459e-12,1993-03-08
9408384,3,3,0,0.0,5.344521023774459e-12,1994-08-29
9410331,1,1,0,0.0,7.451545320850212e-16,1994-10-20
9411435,1,1,0,0.0,7.451545320850212e-16,1994-11-29
9503431,1,1,0,0.0,7.451545320850212e-16,1995-03-24
9507378,3,3,0,0.0,5.344521023774459e-12,1995-07-21
9512230,1,1,0,0.0,7.451545320850212e-16,1995-12-04
9605432,1,1,0,0.0,7.451545320850212e-16,1996-05-30
9606203,1,1,0,0.0,7.451545320850212e-16,1996-06-03
9607448,2,2,0,0.0,1.7868434498168393e-15,1996-07-27
9608224,2,1,1,3.3825632364365045e-06,7.451545320850212e-16,1996-08-04
9609344,1,1,0,0.0,7.451545320850212e-16,1996-09-13
9609434,1,1,0,0.0,7.451545320850212e-16,1996-09-22
9609444,2,1,1,3.3825632364365045e-06,7.451545320850212e-16,1996-09-23
9609524,1,1,0,0.0,7.451545320850212e-16,1996-09-30
9610358,1,1,0,0.0,7.451545320850212e-16,1996-10-14
9611229,1,1,0,0.0,7.451545320850212e-16,1996-11-04
9612321,1,1,0,0.0,7.451545320850212e-16,1996-12-11
9612426,1,1,0,0.0,7.451545320850212e-16,1996-12-19
9612490,1,1,0,0.0,7.451545320850212e-16,1996-12-30
9701286,1,1,0,0.0,7.451545320850212e-16,1997-01-13
9701341,2,1,1,3.3825632364365045e-06,7.451545320850212e-16,1997-01-21
9702307,1,1,0,0.0,7.451545320850212e-16,1997-02-11
9703211,2,1,1,3.3825632364365045e-06,7.451545320850212e-16,1997-03-02
111053,1,0,1,0.0,8.211974124807393e-20,2000-01-28
111053,1,0,1,0.0,8.211974124807393e-20,2001-11-06
9404282,1,1,0,0.0,1.3672690558580606e-14,1994-04-18
9404283,1,1,0,0.0,1.3672690558580606e-14,1994-04-18
9408404,1,1,0,0.0,1.3672690558580606e-14,1994-08-31
9504327,1,1,0,0.0,1.3672690558580606e-14,1995-04-18
9612446,1,1,0,0.0,1.3672690558580606e-14,1996-12-22
9701396,1,1,0,0.0,1.3672690558580606e-14,1997-01-28
9711246,1,1,0,0.0,1.3672690558580606e-14,1997-11-06
9711262,1,1,0,0.0,1.3672690558580606e-14,1997-11-07
9711469,1,1,0,0.0,1.3672690558580606e-14,1997-11-25
9712224,1,1,0,0.0,1.3672690558580606e-14,1997-12-01
9712225,1,1,0,0.0,1.3672690558580606e-14,1997-12-01
9712287,1,1,0,0.0,1.3672690558580606e-14,1997-12-08
9802361,1,1,0,0.0,1.3672690558580606e-14,1998-02-19
9802433,1,1,0,0.0,1.3672690558580606e-14,1998-02-26
9804319,1,1,0,0.0,1.3672690558580606e-14,1998-04-17
9806348,1,1,0,0.0,1.3672690558580606e-14,1998-06-11
9808493,2,2,0,0.0,6.500992141798355e-05,1998-08-31
9809311,2,2,0,0.0,6.500992141798355e-05,1998-09-09
9810260,1,1,0,0.0,1.3672690558580606e-14,1998-10-06
9810397,1,1,0,0.0,1.3672690558580606e-14,1998-10-19
9810482,1,1,0,0.0,1.3672690558580606e-14,1998-10-26
9812278,1,1,0,0.0,1.3672690558580606e-14,1998-12-08
9812396,2,2,0,0.0,6.500992141798355e-05,1998-12-16
9812444,1,1,0,0.0,1.3672690558580606e-14,1998-12-19
8292,1,0,1,0.0,8.211974124807393e-20,2000-08-28
11355,2,0,2,0.0,8.211974124807393e-20,2000-11-28
201298,2,1,1,2.0412019530220286e-06,7.7767394961926e-17,2002-01-31
9905277,30,10,20,2.3328022320251757e-05,2.210581314656903e-15,1999-05-10
9301278,1,1,0,0.0,2.3040828520419612e-14,1993-01-26
9308226,1,1,0,0.0,2.3040828520419612e-14,1993-08-04
9308313,1,1,0,0.0,2.3040828520419612e-14,1993-08-20
9311256,1,1,0,0.0,2.3040828520419612e-14,1993-11-10
9312262,1,1,0,0.0,2.3040828520419612e-14,1993-12-10
9401288,1,1,0,0.0,2.3040828520419612e-14,1994-01-19
9403370,1,1,0,0.0,2.3040828520419612e-14,1994-03-27
9502378,1,1,0,0.0,2.3040828520419612e-14,1995-02-23
9508255,1,1,0,0.0,2.3040828520419612e-14,1995-08-07
9512225,2,2,0,0.0,6.500992142735168e-05,1995-12-04
9703437,1,1,0,0.0,2.3040828520419612e-14,1997-03-27
9705235,2,2,0,0.0,3.471127554788963e-14,1997-05-05
9706520,1,1,0,0.0,2.3040828520419612e-14,1997-06-26
9710216,1,1,0,0.0,2.3040828520419612e-14,1997-10-01
9711248,1,1,0,0.0,2.3040828520419612e-14,1997-11-06
9805422,1,1,0,0.0,2.3040828520419612e-14,1998-05-22
9810402,1,1,0,0.0,2.3040828520419612e-14,1998-10-19
9810421,1,1,0,0.0,2.3040828520419612e-14,1998-10-20
9901378,1,1,0,0.0,2.3040828520419612e-14,1999-01-22
9903518,3,3,0,0.0,6.500992143902214e-05,1999-03-29
6003,2,1,1,2.0412019530220286e-06,7.7767394961926e-17,2000-06-01
11266,1,0,1,0.0,8.211974124807393e-20,2000-11-21
4233,17,3,14,5.832005580062939e-06,1.0675566362249613e-17,2000-04-26
2229,2,1,1,0.0,2.2607564765594756e-16,2000-02-22
3207,2,1,1,0.0,2.2607564765594756e-16,2000-03-21
3328,1,1,0,0.0,2.2607564765594756e-16,2000-03-31
4086,1,1,0,0.0,2.2607564765594756e-16,2000-04-10
9907218,2,1,1,0.0,2.2607564765594756e-16,1999-07-04
9907447,2,1,1,0.0,2.2607564765594756e-16,1999-07-21
9909496,2,1,1,0.0,2.2607564765594756e-16,1999-09-23
9912552,2,1,1,0.0,2.2607564765594756e-16,1999-12-31
109064,44,21,23,4.5327643369489176e-05,0.00011205188847190302,2001-09-07
1230,1,1,0,0.0,0.0001071761415115133,2000-01-22
3326,3,3,0,0.0,0.00011042663948491245,2000-03-31
10177,1,1,0,0.0,0.0001071761415115133,2000-10-16
103044,2,2,0,0.0,0.00011042663948476059,2001-03-04
104121,1,1,0,0.0,0.0001071761415115133,2001-04-11
104134,2,2,0,0.0,0.00010717614151166516,2001-04-13
111107,4,3,1,0.0,0.00011042663948491245,2001-11-09
9404201,2,2,0,0.0,0.00010717614151151685,1994-04-01
9406214,2,2,0,0.0,0.00011042663948476059,1994-06-02
9409250,1,1,0,0.0,0.0001071761415115133,1994-09-07
9604327,1,1,0,0.0,0.0001071761415115133,1996-04-16
9604398,3,3,0,0.0,0.00011042663948491245,1996-04-24
9607440,1,1,0,0.0,0.0001071761415115133,1996-07-26
9612431,1,1,0,0.0,0.0001071761415115133,1996-12-20
9709449,1,1,0,0.0,0.0001071761415115133,1997-09-24
9801430,2,2,0,0.0,0.00010717614151203593,1998-01-29
9804212,1,1,0,0.0,0.0001071761415115133,1998-04-02
9804224,3,3,0,0.0,0.00011042663948491245,1998-04-03
9807540,1,1,0,0.0,0.0001071761415115133,1998-07-29
9810216,2,2,0,0.0,0.00010717614151203593,1998-10-01
9903478,2,2,0,0.0,0.00011042663948476059,1999-03-24
9910367,1,1,0,0.0,0.0001071761415115133,1999-10-16
9911367,2,2,0,0.0,0.00010717614151166516,1999-11-15
111114,2,1,1,0.0,1.519215213089368e-16,2001-11-09
9609256,2,2,0,0.0,3.2504979733992026e-06,1996-09-05
4171,2,1,1,0.0,4.485380266969801e-16,2000-04-18
110215,1,0,1,0.0,8.211974124807393e-20,2001-10-16
107197,26,12,14,1.7690416926190917e-05,1.1661003257226504e-16,2001-07-18
201206,1,0,1,0.0,8.211974124807393e-20,2002-01-22
9809352,1,0,1,0.0,8.211974124807393e-20,1998-09-12
9811363,2,1,1,0.0,4.485380266969801e-16,1998-11-17
9902293,2,1,1,0.0,4.485380266969801e-16,1999-02-10
202269,47,6,41,2.391122287825805e-05,2.1269012983251138e-17,2002-02-27
9909249,1,0,1,0.0,8.211974124807393e-20,1999-09-03
102255,4,3,1,1.5968710466027951e-06,0.22941560474559158,2001-02-20
111068,1,0,1,0.0,8.211974124807393e-20,2000-01-28
111068,1,0,1,0.0,8.211974124807393e-20,2001-11-07
9605258,28,5,23,9.493209083102452e-05,3.969019545976034e-14,1996-05-08
108079,1,0,1,0.0,8.211974124807393e-20,2001-08-08
104278,63,5,58,0.00017791626182691794,1.0226289257881377e-14,2001-04-26
103012,3,2,1,1.5968710466027951e-06,3.087849265264409e-13,2001-03-01
6097,1,1,0,0.0,1.0273179630134032e-13,2000-06-10
8209,1,1,0,0.0,1.0273179630134032e-13,2000-08-18
102122,5,5,0,0.0,0.22941560481874146,2001-02-09
102131,3,3,0,0.0,0.22941560481853465,2001-02-11
102146,5,5,0,0.0,0.22941560481874146,2001-02-12
102147,5,5,0,0.0,0.22941560481874146,2001-02-12
102180,3,3,0,0.0,0.22941560481853465,2001-02-14
102193,4,4,0,0.0,0.22941560481874068,2001-02-15
102199,4,4,0,0.0,0.22941560481874068,2001-02-15
102204,5,5,0,0.0,0.22941560481874146,2001-02-16
102211,2,2,0,0.0,0.22941560474538555,2001-02-16
102222,2,2,0,0.0,7.325182608203769e-11,2001-02-18
102238,2,2,0,0.0,7.325182608203769e-11,2001-02-19
102242,2,2,0,0.0,7.325182608203769e-11,2001-02-19
102259,4,3,1,0.0,0.22941560481853465,2001-02-21
102297,2,2,0,0.0,7.325182608203769e-11,2001-02-23
102304,3,2,1,1.5968710466027951e-06,3.087849265264409e-13,2001-02-24
102312,1,1,0,0.0,1.0273179630134032e-13,2001-02-26
102315,4,4,0,0.0,3.9342656502824327e-13,2001-02-26
102324,3,2,1,2.7361949938508045e-06,1.034768687136841e-13,2001-02-27
102344,3,3,0,0.0,3.0952999893878467e-13,2001-02-28
103034,1,1,0,0.0,1.0273179630134032e-13,2001-03-02
103048,3,2,1,1.5968710466027951e-06,3.087849265264409e-13,2001-03-05
103050,2,2,0,0.0,3.087849265264409e-13,2001-03-05
103054,2,2,0,0.0,3.087849265264409e-13,2001-03-06
103067,3,3,0,0.0,3.0952999893878467e-13,2001-03-06
103069,2,1,1,0.0,1.0273179630134032e-13,2001-03-07
103072,1,1,0,0.0,1.0273179630134032e-13,2001-03-07
103083,2,1,1,0.0,1.0273179630134032e-13,2001-03-08
103105,39,14,25,6.631341571758372e-05,1.1425742023793478e-11,2001-03-10
103126,1,1,0,0.0,1.0273179630134032e-13,2001-03-12
103127,1,1,0,0.0,1.0273179630134032e-13,2001-03-13
103182,3,3,0,0.0,3.0952999893878467e-13,2001-03-16
103183,3,2,1,5.5001911449358295e-06,3.087849265264409e-13,2001-03-16
103199,2,2,0,0.0,1.034768687136841e-13,2001-03-19
103218,4,2,2,7.097062191538622e-06,3.087849265264409e-13,2001-03-20
103223,2,1,1,0.0,1.0273179630134032e-13,2001-03-20
103224,4,2,2,7.097062191538622e-06,3.087849265264409e-13,2001-03-20
103235,1,1,0,0.0,1.0273179630134032e-13,2001-03-21
103247,1,1,0,0.0,1.0273179630134032e-13,2001-03-23
103256,2,2,0,0.0,3.087849265264409e-13,2001-03-23
103280,2,2,0,0.0,1.034768687136841e-13,2001-03-27
103317,1,1,0,0.0,1.0273179630134032e-13,2001-03-29
104056,1,1,0,0.0,1.0273179630134032e-13,2001-04-05
104106,2,2,0,0.0,3.087849265264409e-13,2001-04-11
104141,2,1,1,0.0,1.0273179630134032e-13,2001-04-14
104151,2,2,0,0.0,3.087849265264409e-13,2001-04-16
104174,2,2,0,0.0,3.087849265264409e-13,2001-04-18
104225,3,2,1,5.5001911449358295e-06,3.087849265264409e-13,2001-04-23
104242,2,1,1,1.6524015810178328e-05,1.0273179630134032e-13,2001-04-24
9902310,3,3,0,0.0,1.0629825666374417e-13,1999-02-10
9612293,1,0,1,0.0,8.211974124807393e-20,1996-12-09
9702375,1,0,1,0.0,8.211974124807393e-20,1997-02-20
9612333,1,0,1,0.0,8.211974124807393e-20,1996-12-11
9911262,1,0,1,0.0,8.211974124807393e-20,1999-11-05
9906234,1,0,1,0.0,8.211974124807393e-20,1999-06-03
9905266,1,0,1,0.0,8.211974124807393e-20,1999-05-06
7161,1,0,1,0.0,8.211974124807393e-20,2000-07-15
101033,2,0,2,0.0,8.211974124807393e-20,2001-01-03
107048,1,0,1,0.0,8.211974124807393e-20,2001-07-05
201195,2,1,1,1.4580013950157348e-06,3.613268614915252e-18,2002-01-22
201022,36,2,34,4.34484415714689e-05,6.1619369042904794e-15,2002-01-04
104316,1,0,1,0.0,8.211974124807393e-20,2001-04-30
3189,32,7,25,2.8576827342308404e-05,2.4800161856918278e-17,2000-03-20
2150,2,1,1,0.0,4.485380266969801e-16,2000-02-14
2264,1,1,0,0.0,5.226921530439902e-16,2000-02-25
9205214,2,2,0,0.0,2.6766929659809694e-15,1992-05-09
9402241,2,2,0,0.0,2.6766929659809694e-15,1994-02-07
9505359,2,2,0,0.0,2.6766929659809694e-15,1995-05-23
9610229,2,2,0,0.0,2.6766929659809694e-15,1996-10-03
9706239,1,1,0,0.0,5.226921530439902e-16,1997-06-03
9708483,2,2,0,0.0,9.711480599997217e-16,1997-08-29
9805281,2,2,0,0.0,2.6766929659809694e-15,1998-05-11
9806516,2,2,0,0.0,2.6766929659809694e-15,1998-06-29
9806540,1,1,0,0.0,5.226921530439902e-16,1998-06-30
9807216,2,2,0,0.0,8.516079950597265e-14,1998-07-02
9807267,1,1,0,0.0,5.226921530439902e-16,1998-07-07
9808307,2,2,0,0.0,2.6766929659809694e-15,1998-08-12
9811352,1,1,0,0.0,5.226921530439902e-16,1998-11-16
9901433,1,1,0,0.0,5.226921530439902e-16,1999-01-27
9903464,1,1,0,0.0,5.226921530439902e-16,1999-03-24
9905388,1,1,0,0.0,5.226921530439902e-16,1999-05-18
9905461,1,1,0,0.0,5.226921530439902e-16,1999-05-24
9910286,2,2,0,0.0,6.249435488590301e-14,1999-10-11
9912268,1,1,0,0.0,5.226921530439902e-16,1999-12-08
9911341,3,2,1,3.1104029760335676e-06,6.2420200759556e-14,1999-11-15
112177,1,0,1,0.0,8.211974124807393e-20,2001-12-13
5024,1,0,1,0.0,8.211974124807393e-20,2000-05-03
105096,1,0,1,0.0,8.211974124807393e-20,2001-05-10
108117,1,0,1,0.0,8.211974124807393e-20,2001-08-14
109156,1,0,1,0.0,8.211974124807393e-20,2001-09-18
6014,1,0,1,0.0,8.211974124807393e-20,2000-06-01
9910314,1,0,1,0.0,8.211974124807393e-20,1999-10-12
101350,2,1,1,0.0,4.485380266969801e-16,2001-01-31
6223,1,0,1,0.0,8.211974124807393e-20,2000-06-19
9712464,1,0,1,0.0,8.211974124807393e-20,1997-12-19
9611409,2,0,2,0.0,8.211974124807393e-20,1996-11-25
9706315,2,1,1,7.136106827827013e-05,7.451545320850212e-16,1997-06-10
9505289,1,0,1,0.0,8.211974124807393e-20,1995-05-11
111245,1,0,1,0.0,8.211974124807393e-20,2001-11-20
108059,1,0,1,0.0,8.211974124807393e-20,2001-08-06
3246,1,0,1,0.0,8.211974124807393e-20,2000-03-24
104047,1,0,1,0.0,8.211974124807393e-20,2001-04-04
9809517,1,0,1,0.0,8.211974124807393e-20,1998-09-24
9912236,1,0,1,0.0,8.211974124807393e-20,1999-12-03
9511342,1,0,1,0.0,8.211974124807393e-20,1995-11-16
111028,1,0,1,0.0,8.211974124807393e-20,2000-01-25
111028,1,0,1,0.0,8.211974124807393e-20,2001-11-02
101342,1,1,0,0.0,1.1159251638200775e-15,2001-01-31
102027,1,1,0,0.0,1.1159251638200775e-15,2001-02-02
104016,1,1,0,0.0,1.1159251638200775e-15,2001-04-02
104024,1,1,0,0.0,1.1159251638200775e-15,2001-04-02
106029,1,1,0,0.0,1.1159251638200775e-15,2001-06-04
9409381,1,1,0,0.0,1.1159251638200775e-15,1994-09-22
9411260,1,1,0,0.0,1.1159251638200775e-15,1994-11-10
9411426,3,3,0,0.0,1.4937580933024664e-15,1994-11-29
9412309,1,1,0,0.0,1.1159251638200775e-15,1994-07-02
9504241,2,2,0,0.0,1.777051491870419e-13,1995-04-06
9602340,1,1,0,0.0,1.1159251638200775e-15,1996-02-19
9602390,1,1,0,0.0,1.1159251638200775e-15,1996-02-25
9603349,1,1,0,0.0,1.1159251638200775e-15,1996-03-19
9606215,1,1,0,0.0,1.1159251638200775e-15,1996-06-04
9609202,1,1,0,0.0,1.1159251638200775e-15,1996-08-30
9712319,1,1,0,0.0,1.1159251638200775e-15,1997-12-09
9712368,1,1,0,0.0,1.1159251638200775e-15,1997-12-13
9805273,1,1,0,0.0,1.1159251638200775e-15,1998-05-10
9809470,2,2,0,0.0,1.1936104390407558e-15,1998-09-21
9810531,1,1,0,0.0,1.1159251638200775e-15,1998-10-29
9903387,2,2,0,0.0,0.22941560474528397,1999-03-17
9903394,1,1,0,0.0,1.1159251638200775e-15,1999-03-18
9909335,1,1,0,0.0,1.1159251638200775e-15,1999-09-13
9909537,1,1,0,0.0,1.1159251638200775e-15,1999-09-28
9911266,1,1,0,0.0,1.1159251638200775e-15,1999-11-08
9701343,1,0,1,0.0,8.211974124807393e-20,1997-01-21
9904299,1,0,1,0.0,8.211974124807393e-20,1999-04-12
9807443,6,4,2,3.3048031620356655e-05,7.557479787060251e-16,1998-07-21
106346,1,0,1,0.0,8.211974124807393e-20,2001-06-29
9505397,2,1,1,4.9766447616537095e-06,1.2642334165141024e-15,1995-05-28
9711217,1,0,1,0.0,8.211974124807393e-20,1997-11-04
201287,1,0,1,0.0,8.211974124807393e-20,2002-01-30
9809363,49,29,20,0.00011080810602119585,1.0248543707759627e-16,1998-09-14
111359,1,0,1,0.0,8.211974124807393e-20,2001-11-27
12184,30,14,16,4.2087640269454214e-05,4.9518203972588843e-17,2000-12-15
6319,1,0,1,0.0,8.211974124807393e-20,2000-06-28
9906311,1,0,1,0.0,8.211974124807393e-20,1999-06-10
9809205,1,0,1,0.0,8.211974124807393e-20,1998-09-01
9902312,1,0,1,0.0,8.211974124807393e-20,1999-02-11
9809458,1,0,1,0.0,8.211974124807393e-20,1998-09-20
9604202,1,0,1,0.0,8.211974124807393e-20,1996-04-01
9805488,1,0,1,0.0,8.211974124807393e-20,1998-05-27
9701291,40,20,20,3.88800372004196e-05,7.070509721459217e-17,1997-01-14
3154,4,3,1,4.895644684152833e-05,2.9521225781270094e-15,2000-03-16
9704450,2,0,2,0.0,8.211974124807393e-20,1997-04-30
9609210,25,11,14,1.9974619111715567e-05,1.2274355604608372e-14,1996-08-30
9701300,1,0,1,0.0,8.211974124807393e-20,1997-01-15
9905415,1,0,1,0.0,8.211974124807393e-20,1999-05-20
9905311,1,0,1,0.0,8.211974124807393e-20,1999-05-11
9304223,2,2,0,0.0,2.8991553450220077e-15,1993-04-06
9306290,2,2,0,0.0,4.00464144733462e-13,1993-06-18
9403290,2,2,0,0.0,2.8991553450220077e-15,1994-03-15
9502266,2,2,0,0.0,2.8991553450220077e-15,1995-02-09
9509256,1,1,0,0.0,2.8214700698013298e-15,1995-09-08
9601203,2,2,0,0.0,2.8991553450220077e-15,1996-01-02
9605353,1,1,0,0.0,2.8214700698013298e-15,1996-05-20
9703434,1,1,0,0.0,2.8214700698013298e-15,1997-03-26
9707258,1,1,0,0.0,2.8214700698013298e-15,1997-07-07
9710204,1,1,0,0.0,2.8214700698013298e-15,1997-10-01
9710371,1,1,0,0.0,2.8214700698013298e-15,1997-10-15
9712551,1,1,0,0.0,2.8214700698013298e-15,1997-12-31
9803466,1,1,0,0.0,2.8214700698013298e-15,1998-03-26
9806292,2,2,0,0.0,5.140544209087077e-12,1998-06-05
9808357,3,2,1,8.764208385594584e-05,2.8991553450220077e-15,1998-08-18
9809217,1,1,0,0.0,2.8214700698013298e-15,1998-09-01
9809582,1,1,0,0.0,2.8214700698013298e-15,1998-09-29
9810535,1,1,0,0.0,2.8214700698013298e-15,1998-10-29
9811337,1,1,0,0.0,2.8214700698013298e-15,1998-11-15
9811350,1,1,0,0.0,2.8214700698013298e-15,1998-11-16
9811356,1,1,0,0.0,2.8214700698013298e-15,1998-11-17
9811501,1,1,0,0.0,2.8214700698013298e-15,1998-11-28
9812401,1,1,0,0.0,2.8214700698013298e-15,1998-12-17
9812402,2,2,0,0.0,2.8991553450220077e-15,1998-12-17
9901209,1,1,0,0.0,2.8214700698013298e-15,1999-01-03
9902246,1,1,0,0.0,2.8214700698013298e-15,1999-02-05
9902263,1,1,0,0.0,2.8214700698013298e-15,1999-02-08
9902323,2,2,0,0.0,3.566542482145103e-15,1999-02-11
9902407,1,1,0,0.0,2.8214700698013298e-15,1999-02-19
9903294,1,1,0,0.0,2.8214700698013298e-15,1999-03-09
9903298,2,2,0,0.0,3.566542482145103e-15,1999-03-09
9903400,1,1,0,0.0,2.8214700698013298e-15,1999-03-18
9903479,1,1,0,0.0,2.8214700698013298e-15,1999-03-24
9904211,1,1,0,0.0,2.8214700698013298e-15,1999-04-01
9907362,1,0,1,0.0,8.211974124807393e-20,1999-07-14
9906431,1,0,1,0.0,8.211974124807393e-20,1999-06-21
9909523,1,0,1,0.0,8.211974124807393e-20,1999-09-28
7313,3,1,2,0.00017010872561717147,1.0354984688533647e-11,2000-07-27
3238,2,0,2,0.0,8.211974124807393e-20,2000-03-23
9909564,1,0,1,0.0,8.211974124807393e-20,1999-09-30
8226,2,0,2,0.0,8.211974124807393e-20,2000-08-22
9911233,1,0,1,0.0,8.211974124807393e-20,1999-11-04
9908340,1,0,1,0.0,8.211974124807393e-20,1999-08-12
9806462,1,0,1,0.0,8.211974124807393e-20,1998-06-24
7148,1,0,1,0.0,8.211974124807393e-20,2000-07-14
1297,1,1,0,0.0,7.7767394961926e-17,2000-01-28
8255,1,1,0,0.0,7.7767394961926e-17,2000-08-24
11336,1,1,0,0.0,7.7767394961926e-17,2000-11-28
101023,1,1,0,0.0,7.7767394961926e-17,2001-01-02
105003,1,1,0,0.0,7.7767394961926e-17,2001-05-01
105154,1,1,0,0.0,7.7767394961926e-17,2001-05-16
202018,2,2,0,0.0,8.12985438355932e-17,2002-02-04
9204229,1,1,0,0.0,7.7767394961926e-17,1992-04-22
9305348,1,1,0,0.0,7.7767394961926e-17,1993-05-31
9306320,2,2,0,0.0,1.4655089023131274e-15,1993-06-26
9309272,1,1,0,0.0,7.7767394961926e-17,1993-09-15
9312258,1,1,0,0.0,7.7767394961926e-17,1993-12-10
9401277,1,1,0,0.0,7.7767394961926e-17,1994-01-18
9402340,1,1,0,0.0,7.7767394961926e-17,1994-02-22
9409313,1,1,0,0.0,7.7767394961926e-17,1994-09-15
9410280,1,1,0,0.0,7.7767394961926e-17,1994-10-13
9602242,1,1,0,0.0,7.7767394961926e-17,1996-02-07
9608211,1,1,0,0.0,7.7767394961926e-17,1996-08-02
9608277,1,1,0,0.0,7.7767394961926e-17,1996-08-09
9706303,1,1,0,0.0,7.7767394961926e-17,1997-06-09
9709243,1,1,0,0.0,7.7767394961926e-17,1997-09-04
9801222,1,1,0,0.0,7.7767394961926e-17,1998-01-06
9801443,1,1,0,0.0,7.7767394961926e-17,1998-01-29
9802224,1,1,0,0.0,7.7767394961926e-17,1998-02-03
9802412,1,1,0,0.0,7.7767394961926e-17,1998-02-25
9805468,1,1,0,0.0,7.7767394961926e-17,1998-05-26
9812358,1,1,0,0.0,7.7767394961926e-17,1998-12-14
9812375,1,1,0,0.0,7.7767394961926e-17,1998-12-15
9905312,1,1,0,0.0,7.7767394961926e-17,1999-05-11
9707485,1,0,1,0.0,8.211974124807393e-20,1997-07-27
9203225,1,1,0,0.0,1.4866957955551365e-15,1992-03-30
9208221,1,1,0,0.0,1.4866957955551365e-15,1992-08-11
9209241,1,1,0,0.0,1.4866957955551365e-15,1992-09-15
9209262,1,1,0,0.0,1.4866957955551365e-15,1992-09-21
9307241,1,1,0,0.0,1.4866957955551365e-15,1993-07-10
9307242,1,1,0,0.0,1.4866957955551365e-15,1993-07-10
9307243,1,1,0,0.0,1.4866957955551365e-15,1993-07-10
9401276,1,1,0,0.0,1.4866957955551365e-15,1994-01-17
9406227,1,1,0,0.0,1.4866957955551365e-15,1994-06-03
9510421,1,1,0,0.0,1.4866957955551365e-15,1995-10-26
9510448,1,1,0,0.0,1.4866957955551365e-15,1995-10-30
9512228,1,1,0,0.0,1.4866957955551365e-15,1995-12-04
9512231,1,1,0,0.0,1.4866957955551365e-15,1995-12-05
9512242,1,1,0,0.0,1.4866957955551365e-15,1995-12-05
9605289,1,1,0,0.0,1.4866957955551365e-15,1996-05-13
9606326,1,1,0,0.0,1.4866957955551365e-15,1996-06-13
9612266,1,1,0,0.0,1.4866957955551365e-15,1996-12-05
9612441,1,1,0,0.0,1.4866957955551365e-15,1996-12-20
9701234,1,1,0,0.0,1.4866957955551365e-15,1997-01-07
110129,1,0,1,0.0,8.211974124807393e-20,2001-10-09
103080,1,0,1,0.0,8.211974124807393e-20,2001-03-07
201236,1,0,1,0.0,8.211974124807393e-20,2002-01-24
9910551,1,0,1,0.0,8.211974124807393e-20,1999-10-29
9903226,1,0,1,0.0,8.211974124807393e-20,1999-03-02
9910271,1,0,1,0.0,8.211974124807393e-20,1999-10-07
9508254,1,0,1,0.0,8.211974124807393e-20,1995-08-07
9701219,1,0,1,0.0,8.211974124807393e-20,1997-01-06
11323,1,0,1,0.0,8.211974124807393e-20,2000-11-27
11392,1,0,1,0.0,8.211974124807393e-20,2000-11-30
9909377,1,0,1,0.0,8.211974124807393e-20,1999-09-14
5142,1,0,1,0.0,8.211974124807393e-20,2000-05-15
102228,1,0,1,0.0,8.211974124807393e-20,2001-02-19
9809483,2,1,1,4.568404371049302e-05,9.437709806624386e-14,1998-09-22
9808299,1,0,1,0.0,8.211974124807393e-20,1998-08-11
9603315,1,0,1,0.0,8.211974124807393e-20,1996-03-14
101230,1,0,1,0.0,8.211974124807393e-20,2001-01-20
9901312,38,7,31,2.1092420181227632e-05,2.4800161856918278e-17,1999-01-14
101278,1,0,1,0.0,8.211974124807393e-20,2001-01-24
9911327,33,10,23,8.710748334444007e-05,3.53936084779198e-17,1999-11-12
9906341,1,0,1,0.0,8.211974124807393e-20,1999-06-11
107309,1,0,1,0.0,8.211974124807393e-20,2001-07-30
102130,21,5,16,7.776007440083919e-06,1.773786410958398e-17,2001-02-11
201071,6,0,6,0.0,8.211974124807393e-20,2002-01-10
9704323,27,8,19,1.4709614074158745e-05,2.833131073058542e-17,1997-04-14
109197,1,0,1,0.0,8.211974124807393e-20,2001-09-21
9906274,1,0,1,0.0,8.211974124807393e-20,1999-06-07
12057,29,14,15,2.036341948371976e-05,4.9518203972588843e-17,2000-12-05
2004,1,1,0,0.0,1.0417710374730663e-15,2000-02-01
9403364,1,1,0,0.0,1.0417710374730663e-15,1994-03-25
9407247,1,1,0,0.0,1.0417710374730663e-15,1994-07-06
9506283,2,2,0,0.0,1.3419186917347763e-15,1995-06-09
9602260,3,3,0,0.0,1.567912219649476e-15,1996-02-08
9612264,1,1,0,0.0,1.0417710374730663e-15,1996-12-05
9704452,1,1,0,0.0,1.0417710374730663e-15,1997-04-30
9807339,1,1,0,0.0,1.0417710374730663e-15,1998-07-11
9904206,1,1,0,0.0,1.0417710374730663e-15,1999-04-01
9907510,1,1,0,0.0,1.0417710374730663e-15,1999-07-27
9909387,1,1,0,0.0,1.0417710374730663e-15,1999-09-15
9911257,1,1,0,0.0,1.0417710374730663e-15,1999-11-05
9911302,1,1,0,0.0,1.0417710374730663e-15,1999-11-10
9912212,1,1,0,0.0,1.0417710374730663e-15,1999-12-01
9902416,14,3,11,3.1104029760335676e-06,1.0675566362249613e-17,1999-02-21
111299,1,0,1,0.0,8.211974124807393e-20,2001-11-23
107212,1,0,1,0.0,8.211974124807393e-20,2001-07-19
9507284,1,0,1,0.0,8.211974124807393e-20,1995-07-11
9912302,1,0,1,0.0,8.211974124807393e-20,1999-12-10
9909540,1,0,1,0.0,8.211974124807393e-20,1999-09-28
9703452,1,0,1,0.0,8.211974124807393e-20,1997-03-29
9901246,2,0,2,0.0,8.211974124807393e-20,1999-01-08
9910283,1,0,1,0.0,8.211974124807393e-20,1999-10-08
202122,2,0,2,0.0,8.211974124807393e-20,2002-02-13
7065,1,0,1,0.0,8.211974124807393e-20,2000-07-07
101086,2,1,1,4.665604464050352e-06,1.519215213089368e-16,2001-01-09
4136,1,1,0,0.0,1.519215213089368e-16,2000-04-14
5060,1,1,0,0.0,1.519215213089368e-16,2000-05-06
103046,2,2,0,0.0,1.5545267018260395e-16,2001-03-05
109126,1,1,0,0.0,1.519215213089368e-16,2001-09-14
9406204,2,2,0,0.0,1.5545267018260395e-16,1994-06-01
9406258,1,1,0,0.0,1.519215213089368e-16,1994-06-08
9406271,2,2,0,0.0,1.5545267018260395e-16,1994-06-10
9408313,1,1,0,0.0,1.519215213089368e-16,1994-08-18
9410338,1,1,0,0.0,1.519215213089368e-16,1994-10-20
9504330,2,2,0,0.0,1.426945471823039e-14,1995-04-18
9506417,2,2,0,0.0,1.5545267018260395e-16,1995-06-24
9507246,2,2,0,0.0,1.5545267018260395e-16,1995-07-06
9602415,1,1,0,0.0,1.519215213089368e-16,1996-02-27
9603328,1,1,0,0.0,1.519215213089368e-16,1996-03-17
9605385,2,2,0,0.0,1.5545267018260395e-16,1996-05-23
9612279,1,1,0,0.0,1.519215213089368e-16,1996-12-06
9710426,2,2,0,0.0,1.5545267018260395e-16,1997-10-21
9802329,1,1,0,0.0,1.519215213089368e-16,1998-02-16
9811470,1,1,0,0.0,1.519215213089368e-16,1998-11-25
9903413,1,1,0,0.0,1.519215213089368e-16,1999-03-19
9907254,1,1,0,0.0,1.519215213089368e-16,1999-07-06
9812499,1,0,1,0.0,8.211974124807393e-20,1998-12-24
9708485,1,0,1,0.0,8.211974124807393e-20,1997-08-29
9902244,1,0,1,0.0,8.211974124807393e-20,1999-02-05
9706508,1,0,1,0.0,8.211974124807393e-20,1997-06-25
110220,1,0,1,0.0,8.211974124807393e-20,2001-10-16
9909222,1,0,1,0.0,8.211974124807393e-20,1999-09-02
9906461,17,4,13,4.957204743053498e-06,1.805832207444273e-06,1999-06-23
9906462,2,1,1,0.0,1.8058322074440267e-06,1999-06-23
6049,2,2,0,0.0,7.314983944026844e-11,2000-06-05
101017,1,1,0,0.0,7.31490943678561e-11,2001-01-02
102145,4,4,0,0.0,0.22941560481863874,2001-02-12
9308336,2,2,0,0.0,7.314983944026844e-11,1993-08-25
9507386,2,2,0,0.0,7.314983944026844e-11,1995-07-23
9512396,3,3,0,0.0,7.335589257049356e-11,1995-12-21
9610233,2,2,0,0.0,7.335514749808121e-11,1996-10-03
9707546,1,1,0,0.0,7.31490943678561e-11,1997-07-31
9907319,1,1,0,0.0,7.31490943678561e-11,1999-07-12
9908499,1,1,0,0.0,7.31490943678561e-11,1999-08-30
9908531,1,1,0,0.0,7.31490943678561e-11,1999-08-31
2240,1,0,1,0.0,8.211974124807393e-20,2000-02-23
9807229,1,0,1,0.0,8.211974124807393e-20,1998-07-02
112249,1,0,1,0.0,8.211974124807393e-20,2001-12-18
10175,1,1,0,0.0,4.485380266969801e-16,2000-10-16
103088,2,2,0,0.0,6.003774282646689e-16,2001-03-08
104262,1,1,0,0.0,4.485380266969801e-16,2001-04-25
107060,1,1,0,0.0,4.485380266969801e-16,2001-07-06
9409335,2,2,0,0.0,1.5041375565719479e-09,1994-09-15
9409371,1,1,0,0.0,4.485380266969801e-16,1994-09-21
9504372,1,1,0,0.0,4.485380266969801e-16,1995-04-24
9606362,1,1,0,0.0,4.485380266969801e-16,1996-06-18
9612394,3,3,0,0.0,1.7567746338339367e-09,1996-12-18
9701390,1,1,0,0.0,4.485380266969801e-16,1997-01-27
9703278,1,1,0,0.0,4.485380266969801e-16,1997-03-09
9703284,1,1,0,0.0,4.485380266969801e-16,1997-03-10
9708395,1,1,0,0.0,4.485380266969801e-16,1997-08-18
9709215,2,2,0,0.0,1.5041375565719479e-09,1997-09-02
9801415,1,1,0,0.0,4.485380266969801e-16,1998-01-26
9811261,1,1,0,0.0,4.485380266969801e-16,1998-11-06
9811275,2,1,1,4.422604231547729e-06,4.485380266969801e-16,1998-11-09
9903483,1,1,0,0.0,4.485380266969801e-16,1999-03-25
9906267,1,1,0,0.0,4.485380266969801e-16,1999-06-06
9909475,1,1,0,0.0,4.485380266969801e-16,1999-09-22
9902233,1,0,1,0.0,8.211974124807393e-20,1999-02-03
104027,1,0,1,0.0,8.211974124807393e-20,2001-04-03
5321,1,1,0,0.0,4.485380266969801e-16,2000-05-31
6076,1,1,0,0.0,4.485380266969801e-16,2000-06-08
7011,1,1,0,0.0,4.485380266969801e-16,2000-07-03
7243,1,1,0,0.0,4.485380266969801e-16,2000-07-21
7254,1,1,0,0.0,4.485380266969801e-16,2000-07-24
8020,1,1,0,0.0,4.485380266969801e-16,2000-08-02
9174,2,2,0,0.0,6.2420200759556e-14,2000-09-14
9287,2,2,0,0.0,5.138171277043973e-12,2000-09-25
10088,1,1,0,0.0,4.485380266969801e-16,2000-10-10
101181,2,1,1,0.0,4.485380266969801e-16,2001-01-16
102102,1,1,0,0.0,4.485380266969801e-16,2001-02-08
102103,1,1,0,0.0,4.485380266969801e-16,2001-02-08
102236,1,1,0,0.0,4.485380266969801e-16,2001-02-19
103062,2,2,0,0.0,4.520691755706473e-16,2001-03-06
105139,1,1,0,0.0,4.485380266969801e-16,2001-05-15
105212,1,1,0,0.0,4.485380266969801e-16,2001-05-21
106247,3,3,0,0.0,6.286865666651171e-14,2001-06-21
106258,2,2,0,0.0,6.2420200759556e-14,2001-06-25
106335,1,1,0,0.0,4.485380266969801e-16,2001-06-28
107220,1,1,0,0.0,4.485380266969801e-16,2001-07-20
108020,1,1,0,0.0,4.485380266969801e-16,2001-08-02
108073,2,2,0,0.0,6.2420200759556e-14,2001-08-08
109018,1,1,0,0.0,4.485380266969801e-16,2001-09-03
111150,1,1,0,0.0,4.485380266969801e-16,2001-11-13
111373,1,1,0,0.0,4.485380266969801e-16,2001-11-28
201176,1,1,0,0.0,4.485380266969801e-16,2002-01-18
201291,2,2,0,0.0,4.520691755706473e-16,2002-01-30
202058,2,2,0,0.0,4.520691755706473e-16,2002-02-07
202086,1,1,0,0.0,4.485380266969801e-16,2002-02-08
9304205,1,1,0,0.0,4.485380266969801e-16,1993-04-02
9412385,1,1,0,0.0,4.485380266969801e-16,1994-12-29
9504292,1,1,0,0.0,4.485380266969801e-16,1995-04-12
9610481,1,1,0,0.0,4.485380266969801e-16,1996-10-24
9611277,1,1,0,0.0,4.485380266969801e-16,1996-11-11
9710516,1,1,0,0.0,4.485380266969801e-16,1997-10-29
9712488,1,1,0,0.0,4.485380266969801e-16,1997-12-22
9802314,1,1,0,0.0,4.485380266969801e-16,1998-02-12
9802334,1,1,0,0.0,4.485380266969801e-16,1998-02-16
9806440,1,1,0,0.0,4.485380266969801e-16,1998-06-22
9807228,1,1,0,0.0,4.485380266969801e-16,1998-07-02
9807353,1,1,0,0.0,4.485380266969801e-16,1998-07-13
9808293,2,2,0,0.0,8.508664537962565e-14,1998-08-11
9808296,1,1,0,0.0,4.485380266969801e-16,1998-08-11
9809596,1,1,0,0.0,4.485380266969801e-16,1998-09-30
9810308,1,1,0,0.0,4.485380266969801e-16,1998-10-09
9811252,1,1,0,0.0,4.485380266969801e-16,1998-11-05
9811447,1,1,0,0.0,4.485380266969801e-16,1998-11-23
9811495,1,1,0,0.0,4.485380266969801e-16,1998-11-27
9902204,1,1,0,0.0,4.485380266969801e-16,1999-01-30
9907532,1,1,0,0.0,4.485380266969801e-16,1999-07-28
9909206,1,1,0,0.0,4.485380266969801e-16,1999-09-01
9910522,1,1,0,0.0,4.485380266969801e-16,1999-10-27
9911212,1,1,0,0.0,4.485380266969801e-16,1999-11-03
9911395,1,1,0,0.0,4.485380266969801e-16,1999-11-17
9912492,1,1,0,0.0,4.485380266969801e-16,1999-12-23
201129,1,0,1,0.0,8.211974124807393e-20,2002-01-14
109162,22,1,21,2.0412019530220286e-06,3.613268614915252e-18,2001-09-18
2060,1,1,0,0.0,7.7767394961926e-17,2000-02-04
2292,1,1,0,0.0,7.7767394961926e-17,2000-02-28
6331,1,1,0,0.0,7.7767394961926e-17,2000-06-28
7094,1,1,0,0.0,7.7767394961926e-17,2000-07-11
10325,1,1,0,0.0,7.7767394961926e-17,2000-10-27
11006,1,1,0,0.0,7.7767394961926e-17,2000-11-01
104091,1,1,0,0.0,7.7767394961926e-17,2001-04-09
106060,1,1,0,0.0,7.7767394961926e-17,2001-06-05
9311312,1,1,0,0.0,7.7767394961926e-17,1993-11-18
9403312,1,1,0,0.0,7.7767394961926e-17,1994-03-19
9408333,1,1,0,0.0,7.7767394961926e-17,1994-08-21
9606467,1,1,0,0.0,7.7767394961926e-17,1996-06-28
9607446,1,1,0,0.0,7.7767394961926e-17,1996-07-26
9612400,1,1,0,0.0,7.7767394961926e-17,1996-12-18
9703235,1,1,0,0.0,7.7767394961926e-17,1997-03-04
9707435,1,1,0,0.0,7.7767394961926e-17,1997-07-23
9811427,1,1,0,0.0,7.7767394961926e-17,1998-11-21
9904301,1,1,0,0.0,7.7767394961926e-17,1999-04-12
9906209,1,1,0,0.0,7.7767394961926e-17,1999-06-01
9907481,1,1,0,0.0,7.7767394961926e-17,1999-07-24
9910230,1,1,0,0.0,7.7767394961926e-17,1999-10-04
9902218,1,0,1,0.0,8.211974124807393e-20,1999-02-01
6351,1,0,1,0.0,8.211974124807393e-20,2000-06-30
9904434,20,7,13,1.1372410881122732e-05,1.1123940149464095e-15,1999-04-23
9204207,1,1,0,0.0,1.1670529147211276e-14,1992-04-02
9304225,2,2,0,0.0,1.2267293306861029e-14,1993-04-06
9311325,1,1,0,0.0,1.1670529147211276e-14,1993-11-21
9312359,2,2,0,0.0,1.293468044398413e-14,1993-12-30
9402225,1,1,0,0.0,1.1670529147211276e-14,1994-02-03
9402288,1,1,0,0.0,1.1670529147211276e-14,1994-02-15
9405270,1,1,0,0.0,1.1670529147211276e-14,1994-05-11
9512303,1,1,0,0.0,1.1670529147211276e-14,1995-12-13
9902369,1,1,0,0.0,1.1670529147211276e-14,1999-02-16
9903480,1,1,0,0.0,1.1670529147211276e-14,1999-03-25
110163,1,0,1,0.0,8.211974124807393e-20,2001-10-12
112186,1,0,1,0.0,8.211974124807393e-20,2001-12-13
108123,1,0,1,0.0,8.211974124807393e-20,2001-08-15
102125,1,0,1,0.0,8.211974124807393e-20,2001-02-10
7186,1,0,1,0.0,8.211974124807393e-20,2000-07-18
8245,1,0,1,0.0,8.211974124807393e-20,2000-08-23
9209276,2,2,0,0.0,2.60253883963396e-15,1992-09-24
9211320,1,1,0,0.0,2.154082932678228e-15,1992-11-26
9508275,1,1,0,0.0,2.154082932678228e-15,1995-08-10
9509327,1,1,0,0.0,2.154082932678228e-15,1995-09-19
9511221,1,1,0,0.0,2.154082932678228e-15,1995-11-03
9608270,1,1,0,0.0,2.154082932678228e-15,1996-08-08
9612245,1,1,0,0.0,2.154082932678228e-15,1996-12-04
9706242,1,1,0,0.0,2.154082932678228e-15,1997-06-04
9712493,1,1,0,0.0,2.154082932678228e-15,1997-12-22
9803456,2,1,1,1.87920179802028e-05,2.154082932678228e-15,1998-03-26
9805259,1,1,0,0.0,2.154082932678228e-15,1998-05-08
9809315,2,1,1,1.87920179802028e-05,2.154082932678228e-15,1998-09-10
9910444,1,0,1,0.0,8.211974124807393e-20,1999-10-22
9912215,1,0,1,0.0,8.211974124807393e-20,1999-12-01
9808232,1,0,1,0.0,8.211974124807393e-20,1998-08-05
9708285,1,0,1,0.0,8.211974124807393e-20,1997-08-07
9704349,1,0,1,0.0,8.211974124807393e-20,1997-04-17
9609374,1,0,1,0.0,8.211974124807393e-20,1996-09-16
9612229,2,0,2,0.0,8.211974124807393e-20,1996-12-02
9608275,1,0,1,0.0,8.211974124807393e-20,1996-08-08
9609212,1,0,1,0.0,8.211974124807393e-20,1996-08-30
9802298,1,0,1,0.0,8.211974124807393e-20,1998-02-11
9712447,1,0,1,0.0,8.211974124807393e-20,1997-12-18
9305269,1,1,0,0.0,4.975325284437063e-12,1993-05-14
9308263,1,1,0,0.0,4.975325284437063e-12,1993-08-11
9310316,1,1,0,0.0,4.975325284437063e-12,1993-10-19
9311285,1,1,0,0.0,4.975325284437063e-12,1993-11-12
9407287,1,1,0,0.0,4.975325284437063e-12,1994-07-13
9409212,1,1,0,0.0,4.975325284437063e-12,1994-09-02
9502323,1,1,0,0.0,4.975325284437063e-12,1995-02-16
9505328,1,1,0,0.0,4.975325284437063e-12,1995-05-17
9510232,1,1,0,0.0,4.975325284437063e-12,1995-10-05
9602375,1,1,0,0.0,4.975325284437063e-12,1996-02-23
9604441,1,1,0,0.0,4.975325284437063e-12,1996-04-30
9606314,1,1,0,0.0,4.975325284437063e-12,1996-06-12
9607244,1,1,0,0.0,4.975325284437063e-12,1996-07-05
9608434,1,1,0,0.0,4.975325284437063e-12,1996-08-25
9609445,1,1,0,0.0,4.975325284437063e-12,1996-09-24
9610451,1,1,0,0.0,4.975325284437063e-12,1996-10-22
9703363,1,1,0,0.0,4.975325284437063e-12,1997-03-18
9703420,1,1,0,0.0,4.975325284437063e-12,1997-03-25
9706400,1,1,0,0.0,4.975325284437063e-12,1997-06-18
9709436,1,0,1,0.0,8.211974124807393e-20,1997-09-23
2192,1,1,0,0.0,3.2504979732473635e-06,2000-02-17
3196,1,1,0,0.0,3.2504979732473635e-06,2000-03-20
7087,1,1,0,0.0,3.2504979732473635e-06,2000-07-10
8074,1,1,0,0.0,3.2504979732473635e-06,2000-08-09
9074,1,1,0,0.0,3.2504979732473635e-06,2000-09-06
101251,1,1,0,0.0,3.2504979732473635e-06,2001-01-22
103025,1,1,0,0.0,3.2504979732473635e-06,2001-03-02
104067,1,1,0,0.0,3.2504979732473635e-06,2001-04-06
104075,1,1,0,0.0,3.2504979732473635e-06,2001-04-06
111181,1,1,0,0.0,3.2504979732473635e-06,2000-01-27
111181,1,1,0,0.0,3.2504979732473635e-06,2001-11-14
9311329,1,1,0,0.0,3.2504979732473635e-06,1993-11-22
9403320,1,1,0,0.0,3.2504979732473635e-06,1994-03-21
9509313,1,1,0,0.0,3.2504979732473635e-06,1995-09-17
9701354,1,1,0,0.0,3.2504979732473635e-06,1997-01-23
9701410,1,1,0,0.0,3.2504979732473635e-06,1997-01-29
9708412,1,1,0,0.0,3.2504979732473635e-06,1997-08-19
9710333,1,1,0,0.0,3.2504979732473635e-06,1997-10-13
9712280,1,1,0,0.0,3.2504979732473635e-06,1997-12-05
9801399,1,1,0,0.0,3.2504979732473635e-06,1998-01-23
9903307,1,1,0,0.0,3.2504979732473635e-06,1999-03-10
9909267,1,1,0,0.0,3.2504979732473635e-06,1999-09-07
9909369,1,1,0,0.0,3.2504979732473635e-06,1999-09-14
9904437,1,0,1,0.0,8.211974124807393e-20,1999-04-23
9904336,2,0,2,0.0,8.211974124807393e-20,1999-04-15
104172,18,1,17,3.0132028830325186e-06,3.613268614915252e-18,2001-04-18
112251,1,0,1,0.0,8.211974124807393e-20,2000-02-29
112251,1,0,1,0.0,8.211974124807393e-20,2001-12-19
202166,1,0,1,0.0,8.211974124807393e-20,2002-02-16
9912223,1,0,1,0.0,8.211974124807393e-20,1999-12-02
9811248,2,0,2,0.0,8.211974124807393e-20,1998-11-04
9611443,1,0,1,0.0,8.211974124807393e-20,1996-11-26
9909538,1,0,1,0.0,8.211974124807393e-20,1999-09-28
9609420,3,1,2,1.276561221413777e-05,7.7767394961926e-17,1996-09-20
9903504,1,0,1,0.0,8.211974124807393e-20,1999-03-27
2035,1,0,1,0.0,8.211974124807393e-20,2000-02-03
201088,1,0,1,0.0,8.211974124807393e-20,2002-01-11
106169,41,18,23,4.024083850243428e-05,6.364279946725773e-17,2001-06-15
10227,1,1,0,0.0,1.338387542861113e-15,2000-10-19
101221,1,1,0,0.0,1.338387542861113e-15,2001-01-19
105088,1,1,0,0.0,1.338387542861113e-15,2001-05-10
9405237,1,1,0,0.0,1.338387542861113e-15,1994-05-05
9409362,1,1,0,0.0,1.338387542861113e-15,1994-09-20
9503386,1,1,0,0.0,1.338387542861113e-15,1995-03-20
9608203,1,1,0,0.0,1.338387542861113e-15,1996-08-01
9611433,2,2,0,0.0,2.0093058288578756e-15,1996-11-26
9705278,1,1,0,0.0,1.338387542861113e-15,1997-05-09
9705280,1,1,0,0.0,1.338387542861113e-15,1997-05-09
9706427,1,1,0,0.0,1.338387542861113e-15,1997-06-19
9707264,1,1,0,0.0,1.338387542861113e-15,1997-07-07
9806344,1,1,0,0.0,1.338387542861113e-15,1998-06-11
9806352,1,1,0,0.0,1.338387542861113e-15,1998-06-12
9807448,1,1,0,0.0,1.338387542861113e-15,1998-07-21
9808320,1,1,0,0.0,1.338387542861113e-15,1998-08-13
9810206,1,1,0,0.0,1.338387542861113e-15,1998-10-01
9903337,1,1,0,0.0,1.338387542861113e-15,1999-03-12
9903341,1,1,0,0.0,1.338387542861113e-15,1999-03-12
9908413,1,1,0,0.0,1.338387542861113e-15,1999-08-19
9908483,1,1,0,0.0,1.338387542861113e-15,1999-08-27
9910262,1,1,0,0.0,1.338387542861113e-15,1999-10-07
9912312,1,1,0,0.0,1.338387542861113e-15,1999-12-12
9912498,1,0,1,0.0,8.211974124807393e-20,1999-12-24
12141,1,0,1,0.0,8.211974124807393e-20,2000-12-13
9911457,1,0,1,0.0,8.211974124807393e-20,1999-11-23
9911406,1,0,1,0.0,8.211974124807393e-20,1999-11-19
9708345,1,0,1,0.0,8.211974124807393e-20,1997-08-13
202212,50,7,43,8.427248063190947e-05,8.3547803548378e-15,2002-02-22
112108,2,0,2,0.0,8.211974124807393e-20,2001-12-07
106012,3,1,2,2.8090826877303157e-05,6.710004057380109e-16,2001-06-01
9906358,1,0,1,0.0,8.211974124807393e-20,1999-06-14
9903247,1,0,1,0.0,8.211974124807393e-20,1999-03-03
5089,1,0,1,0.0,8.211974124807393e-20,2000-05-10
7208,2,0,2,0.0,8.211974124807393e-20,2000-07-19
9910237,1,0,1,0.0,8.211974124807393e-20,1999-10-05
105155,1,0,1,0.0,8.211974124807393e-20,2001-05-16
104143,1,0,1,0.0,8.211974124807393e-20,2001-04-15
7008,1,0,1,0.0,8.211974124807393e-20,2000-07-03
9912266,1,0,1,0.0,8.211974124807393e-20,1999-12-08
9302225,2,2,0,0.0,1.0122752688115832e-13,1993-02-05
9303255,1,1,0,0.0,1.0114984160593764e-13,1993-03-14
9509424,1,1,0,0.0,1.0114984160593764e-13,1995-09-29
9602208,2,2,0,0.0,1.0115337275481128e-13,1996-02-01
9603326,2,2,0,0.0,1.0115337275481128e-13,1996-03-15
112312,1,0,1,0.0,8.211974124807393e-20,2001-12-22
6032,1,0,1,0.0,8.211974124807393e-20,2000-06-02
110382,1,0,1,0.0,8.211974124807393e-20,2001-10-30
201232,1,0,1,0.0,8.211974124807393e-20,2002-01-24
9908505,1,0,1,0.0,8.211974124807393e-20,1999-08-30
11370,1,0,1,0.0,8.211974124807393e-20,2000-11-29
1019,1,1,0,0.0,1.8780654852449762e-05,2000-01-03
4043,2,2,0,0.0,1.8780654853194836e-05,2000-04-06
6183,1,1,0,0.0,1.8780654852449762e-05,2000-06-16
6266,1,1,0,0.0,1.8780654852449762e-05,2000-06-22
9355,2,2,0,0.0,1.8780659990172502e-05,2000-09-29
10203,3,2,1,6.77160647907308e-06,1.8780654853194836e-05,2000-10-18
9309218,1,1,0,0.0,1.8780654852449762e-05,1993-09-03
9709292,1,1,0,0.0,1.8780654852449762e-05,1997-09-09
9808456,1,1,0,0.0,1.8780654852449762e-05,1998-08-28
9808459,1,1,0,0.0,1.8780654852449762e-05,1998-08-28
9902237,1,1,0,0.0,1.8780654852449762e-05,1999-02-03
9903501,1,1,0,0.0,1.8780654852449762e-05,1999-03-26
9909228,1,1,0,0.0,1.8780654852449762e-05,1999-09-02
9909478,2,0,2,0.0,8.211974124807393e-20,1999-09-22
9508335,1,0,1,0.0,8.211974124807393e-20,1995-08-21
102316,1,0,1,0.0,8.211974124807393e-20,2001-02-26
2114,1,0,1,0.0,8.211974124807393e-20,2000-02-10
9912424,1,0,1,0.0,8.211974124807393e-20,1999-12-20
9804458,1,0,1,0.0,8.211974124807393e-20,1998-04-30
9911241,1,0,1,0.0,8.211974124807393e-20,1999-11-04
9304257,4,4,0,0.0,1.7567750822898436e-09,1993-04-15
9304302,1,1,0,0.0,5.968462793910005e-16,1993-04-27
9307364,2,2,0,0.0,8.969939336527107e-16,1993-07-29
9311357,1,1,0,0.0,5.968462793910005e-16,1993-11-24
9401254,1,1,0,0.0,5.968462793910005e-16,1994-01-14
9410267,1,1,0,0.0,5.968462793910005e-16,1994-10-11
9501276,1,1,0,0.0,5.968462793910005e-16,1995-01-12
9501281,1,1,0,0.0,5.968462793910005e-16,1995-01-12
9505352,1,1,0,0.0,5.968462793910005e-16,1995-05-20
9506289,1,1,0,0.0,5.968462793910005e-16,1995-06-10
9510403,1,1,0,0.0,5.968462793910005e-16,1995-10-25
9512253,1,1,0,0.0,5.968462793910005e-16,1995-12-07
9603237,1,1,0,0.0,5.968462793910005e-16,1996-03-06
9607389,1,1,0,0.0,5.968462793910005e-16,1996-07-22
9608361,1,1,0,0.0,5.968462793910005e-16,1996-08-19
9612480,1,1,0,0.0,5.968462793910005e-16,1996-12-28
9702312,1,1,0,0.0,5.968462793910005e-16,1997-02-12
9704223,1,1,0,0.0,5.968462793910005e-16,1997-04-03
5275,1,0,1,0.0,8.211974124807393e-20,2000-05-29
6295,1,0,1,0.0,8.211974124807393e-20,2000-06-26
104080,1,0,1,0.0,8.211974124807393e-20,2001-04-09
9811212,1,0,1,0.0,8.211974124807393e-20,1998-11-02
2089,1,0,1,0.0,8.211974124807393e-20,2000-02-08
9507262,3,2,1,2.3994537243687523e-05,1.75677418537803e-09,1995-07-07
9906376,2,1,1,3.061802929533043e-06,1.387823627092449e-15,1999-06-15
2116,2,0,2,0.0,8.211974124807393e-20,2000-02-10
9904329,1,0,1,0.0,8.211974124807393e-20,1999-04-14
9912425,1,0,1,0.0,8.211974124807393e-20,1999-12-20
9909337,1,0,1,0.0,8.211974124807393e-20,1999-09-13
9211304,3,3,0,0.0,1.756774485525684e-09,1992-11-25
9211321,3,3,0,0.0,1.756774485525684e-09,1992-11-26
9212203,3,3,0,0.0,1.756774485525684e-09,1992-12-01
9303284,2,2,0,0.0,1.75677418537803e-09,1993-03-19
9309203,1,1,0,0.0,1.5041371081160408e-09,1993-09-01
9310311,2,2,0,0.0,1.75677418537803e-09,1993-10-19
9402363,1,1,0,0.0,1.5041371081160408e-09,1994-03-01
9501265,2,2,0,0.0,1.5041377048802006e-09,1995-01-11
9504333,1,1,0,0.0,1.5041371081160408e-09,1995-04-19
9509379,2,2,0,0.0,1.5045347507907047e-09,1995-09-25
9511341,1,1,0,0.0,1.5041371081160408e-09,1995-11-16
9604330,2,2,0,0.0,1.75677418537803e-09,1996-04-16
9608281,1,1,0,0.0,1.5041371081160408e-09,1996-08-09
9608365,1,1,0,0.0,1.5041371081160408e-09,1996-08-19
9701278,1,1,0,0.0,1.5041371081160408e-09,1997-01-13
9704249,1,1,0,0.0,1.5041371081160408e-09,1997-04-07
9704354,1,1,0,0.0,1.5041371081160408e-09,1997-04-18
9707523,1,1,0,0.0,1.5041371081160408e-09,1997-07-30
9709484,2,2,0,0.0,1.75677418537803e-09,1997-09-29
9710245,1,1,0,0.0,1.5041371081160408e-09,1997-10-05
9801412,1,1,0,0.0,1.5041371081160408e-09,1998-01-26
9802300,2,2,0,0.0,1.75677418537803e-09,1998-02-11
9802405,2,2,0,0.0,1.75677418537803e-09,1998-02-24
9804462,1,1,0,0.0,1.5041371081160408e-09,1998-04-30
9808487,2,2,0,0.0,1.75677418537803e-09,1998-08-31
9811263,1,1,0,0.0,1.5041371081160408e-09,1998-11-06
9811471,2,2,0,0.0,1.75677418537803e-09,1998-11-25
9811472,1,1,0,0.0,1.5041371081160408e-09,1998-11-25
9812471,1,1,0,0.0,1.5041371081160408e-09,1998-12-22
9902334,2,2,0,0.0,1.75677418537803e-09,1999-02-12
9903230,2,2,0,0.0,1.75677418537803e-09,1999-03-02
9903242,1,1,0,0.0,1.5041371081160408e-09,1999-03-03
9903363,3,3,0,0.0,1.7671291699844437e-09,1999-03-16
9904408,3,3,0,0.0,6.501167817849623e-05,1999-04-20
9905264,1,1,0,0.0,1.5041371081160408e-09,1999-05-06
9905437,1,1,0,0.0,1.5041371081160408e-09,1999-05-21
9905464,2,2,0,0.0,1.5144920927224547e-09,1999-05-24
9905478,1,1,0,0.0,1.5041371081160408e-09,1999-05-25
9906374,2,2,0,0.0,1.5144920927224547e-09,1999-06-15
9906434,2,2,0,0.0,1.75677418537803e-09,1999-06-20
9906497,2,2,0,0.0,1.5041377048802006e-09,1999-06-25
9907307,1,1,0,0.0,1.5041371081160408e-09,1999-07-12
9907335,1,1,0,0.0,1.5041371081160408e-09,1999-07-13
9907446,1,1,0,0.0,1.5041371081160408e-09,1999-07-21
9907514,1,1,0,0.0,1.5041371081160408e-09,1999-07-27
9907572,1,1,0,0.0,1.5041371081160408e-09,1999-07-30
9908232,1,1,0,0.0,1.5041371081160408e-09,1999-08-03
9908255,2,2,0,0.0,1.5144920927224547e-09,1999-08-04
9908268,2,2,0,0.0,1.75677418537803e-09,1999-08-05
9908371,2,2,0,0.0,1.75677418537803e-09,1999-08-16
9908382,1,1,0,0.0,1.5041371081160408e-09,1999-08-17
9908386,1,1,0,0.0,1.5041371081160408e-09,1999-08-17
9403384,1,1,0,0.0,2.5263707734410885e-10,1994-03-29
9409215,1,1,0,0.0,2.5263707734410885e-10,1994-09-02
9409437,1,1,0,0.0,2.5263707734410885e-10,1994-09-29
9512356,1,1,0,0.0,2.5263707734410885e-10,1995-12-19
9706260,1,1,0,0.0,2.5263707734410885e-10,1997-06-05
9908404,1,1,0,0.0,2.5263707734410885e-10,1999-08-18
9908474,1,1,0,0.0,2.5263707734410885e-10,1999-08-26
9909202,1,1,0,0.0,2.5263707734410885e-10,1999-09-01
9909224,1,1,0,0.0,2.5263707734410885e-10,1999-09-02
9909244,1,1,0,0.0,2.5263707734410885e-10,1999-09-03
9909559,1,1,0,0.0,2.5263707734410885e-10,1999-09-29
3297,1,1,0,0.0,3.7438390034996924e-16,2000-03-30
4228,1,1,0,0.0,3.7438390034996924e-16,2000-04-25
9111,1,1,0,0.0,3.7438390034996924e-16,2000-09-10
12244,1,1,0,0.0,3.7438390034996924e-16,2000-12-19
101004,1,1,0,0.0,3.7438390034996924e-16,2000-12-31
9302307,1,1,0,0.0,3.7438390034996924e-16,1993-02-24
9303205,1,1,0,0.0,3.7438390034996924e-16,1993-03-02
9401249,1,1,0,0.0,3.7438390034996924e-16,1994-01-14
9407339,4,4,0,0.0,8.299021050530358e-16,1994-07-20
9411303,1,1,0,0.0,3.7438390034996924e-16,1994-11-15
9507398,2,2,0,0.0,5.262233019176579e-16,1995-07-24
9509375,1,1,0,0.0,3.7438390034996924e-16,1995-09-23
9610381,2,2,0,0.0,5.262233019176579e-16,1996-10-16
9611218,2,2,0,0.0,5.262233019176579e-16,1996-11-03
9803387,1,1,0,0.0,3.7438390034996924e-16,1998-03-18
9911436,2,2,0,0.0,5.262233019176579e-16,1999-11-22
9911390,1,0,1,0.0,8.211974124807393e-20,1999-11-17
110253,2,1,1,3.061802929533043e-06,1.387823627092449e-15,2001-10-18
9605465,2,1,1,4.9766447616537095e-06,1.2642334165141024e-15,1996-06-02
9001,1,0,1,0.0,8.211974124807393e-20,2000-08-31
8023,1,0,1,0.0,8.211974124807393e-20,2000-08-03
9703291,1,0,1,0.0,8.211974124807393e-20,1997-03-11
5189,1,0,1,0.0,8.211974124807393e-20,2000-05-18
3022,1,0,1,0.0,8.211974124807393e-20,2000-03-03
2213,1,0,1,0.0,8.211974124807393e-20,2000-02-19
9908396,1,0,1,0.0,8.211974124807393e-20,1999-08-18
9711216,2,0,2,0.0,8.211974124807393e-20,1997-11-03
9704225,1,0,1,0.0,8.211974124807393e-20,1997-04-03
9709392,1,0,1,0.0,8.211974124807393e-20,1997-09-18
9709511,2,0,2,0.0,8.211974124807393e-20,1997-09-30
9708377,1,0,1,0.0,8.211974124807393e-20,1997-08-17
9812538,1,0,1,0.0,8.211974124807393e-20,1998-12-31
10328,2,0,2,0.0,8.211974124807393e-20,2000-10-30
9209289,1,1,0,0.0,1.2642334165141024e-15,1992-09-28
9310285,1,1,0,0.0,1.2642334165141024e-15,1993-10-14
9405410,1,1,0,0.0,1.2642334165141024e-15,1994-05-30
9504262,1,1,0,0.0,1.2642334165141024e-15,1995-04-10
9504267,1,1,0,0.0,1.2642334165141024e-15,1995-04-10
9510366,1,1,0,0.0,1.2642334165141024e-15,1995-10-22
9704245,2,1,1,4.9766447616537095e-06,1.2642334165141024e-15,1997-04-05
9708396,1,1,0,0.0,1.2642334165141024e-15,1997-08-18
9709333,1,1,0,0.0,1.2642334165141024e-15,1997-09-13
9804275,2,1,1,4.9766447616537095e-06,1.2642334165141024e-15,1998-04-12
9805241,1,1,0,0.0,1.2642334165141024e-15,1998-05-06
9805404,1,1,0,0.0,1.2642334165141024e-15,1998-05-20
9903258,1,0,1,0.0,8.211974124807393e-20,1999-03-04
5278,1,0,1,0.0,8.211974124807393e-20,2000-05-27
9610425,1,0,1,0.0,8.211974124807393e-20,1996-10-20
9131,1,0,1,0.0,8.211974124807393e-20,2000-09-11
10208,1,0,1,0.0,8.211974124807393e-20,2000-10-18
9604376,1,0,1,0.0,8.211974124807393e-20,1996-04-21
9804215,1,0,1,0.0,8.211974124807393e-20,1998-04-02
9512419,1,0,1,0.0,8.211974124807393e-20,1995-12-25
9707395,1,0,1,0.0,8.211974124807393e-20,1997-07-18
105146,1,0,1,0.0,8.211974124807393e-20,2001-05-15
9903203,1,0,1,0.0,8.211974124807393e-20,1999-03-01
109111,1,0,1,0.0,8.211974124807393e-20,2001-09-13
10194,1,1,0,0.0,0.22941560474528283,2000-10-17
102157,3,3,0,0.0,0.2294156047454896,2001-02-13
102176,1,1,0,0.0,0.22941560474528283,2001-02-14
9805376,1,1,0,0.0,0.22941560474528283,1998-05-19
9911386,1,0,1,0.0,8.211974124807393e-20,1999-11-17
9508221,1,0,1,0.0,8.211974124807393e-20,1995-08-02
9912287,1,0,1,0.0,8.211974124807393e-20,1999-12-09
9610461,1,0,1,0.0,8.211974124807393e-20,1996-10-23
105173,1,0,1,0.0,8.211974124807393e-20,2001-05-17
9911490,1,0,1,0.0,8.211974124807393e-20,1999-11-25
9807390,2,0,2,0.0,8.211974124807393e-20,1998-07-15
9904382,2,1,1,1.6038015345173084e-05,8.463818947266991e-14,1999-04-19
102081,1,0,1,0.0,8.211974124807393e-20,2001-02-07
202167,1,0,1,0.0,8.211974124807393e-20,2002-02-16
2039,1,0,1,0.0,8.211974124807393e-20,2000-02-03
102083,1,0,1,0.0,8.211974124807393e-20,2001-02-07
202101,1,0,1,0.0,8.211974124807393e-20,2002-02-11
106116,1,0,1,0.0,8.211974124807393e-20,2001-06-11
9906342,2,0,2,0.0,8.211974124807393e-20,1999-06-11
2191,1,0,1,0.0,8.211974124807393e-20,2000-02-17
9806315,1,0,1,0.0,8.211974124807393e-20,1998-06-09
203067,1,0,1,0.0,8.211974124807393e-20,2002-03-06
203056,1,0,1,0.0,8.211974124807393e-20,2002-03-05
9808448,1,0,1,0.0,8.211974124807393e-20,1998-08-28
105061,1,0,1,0.0,8.211974124807393e-20,2001-05-07
106255,2,0,2,0.0,8.211974124807393e-20,2001-06-22
102317,1,0,1,0.0,8.211974124807393e-20,2001-02-26
3222,1,0,1,0.0,8.211974124807393e-20,2000-03-22
8141,1,0,1,0.0,8.211974124807393e-20,2000-08-14
109217,1,0,1,0.0,8.211974124807393e-20,2001-09-24
104288,1,0,1,0.0,8.211974124807393e-20,2001-04-27
9909389,1,0,1,0.0,8.211974124807393e-20,1999-09-15
2102,1,0,1,0.0,8.211974124807393e-20,2000-02-09
11364,1,0,1,0.0,8.211974124807393e-20,2000-11-29
9158,1,0,1,0.0,8.211974124807393e-20,2000-09-13
10087,1,0,1,0.0,8.211974124807393e-20,2000-10-10
202100,2,0,2,0.0,8.211974124807393e-20,2002-02-11
12076,24,8,16,2.7118825947292666e-05,8.057870681973489e-13,2000-12-06
110049,1,0,1,0.0,8.211974124807393e-20,2001-10-03
9708284,1,0,1,0.0,8.211974124807393e-20,1997-08-07
9811382,1,0,1,0.0,8.211974124807393e-20,1998-11-18
9811278,17,3,14,4.082403906044057e-06,1.0675566362249613e-17,1998-11-09
9611397,1,0,1,0.0,8.211974124807393e-20,1996-11-22
3116,1,0,1,0.0,8.211974124807393e-20,2000-03-13
9906505,1,0,1,0.0,8.211974124807393e-20,1999-06-25
9807519,1,0,1,0.0,8.211974124807393e-20,1998-07-28
9909278,1,0,1,0.0,8.211974124807393e-20,1999-09-07
9909444,1,0,1,0.0,8.211974124807393e-20,1999-09-20
9906504,2,0,2,0.0,8.211974124807393e-20,1999-06-25
9904421,1,0,1,0.0,8.211974124807393e-20,1999-04-21
8238,1,0,1,0.0,8.211974124807393e-20,2000-08-22
9907548,1,0,1,0.0,8.211974124807393e-20,1999-07-29
8258,1,0,1,0.0,8.211974124807393e-20,2000-08-24
8263,1,0,1,0.0,8.211974124807393e-20,2000-08-24
9911214,1,0,1,0.0,8.211974124807393e-20,1999-11-03
7185,1,0,1,0.0,8.211974124807393e-20,2000-07-18
9707242,1,0,1,0.0,8.211974124807393e-20,1997-07-04
6051,1,0,1,0.0,8.211974124807393e-20,2000-06-05
112158,1,0,1,0.0,8.211974124807393e-20,2001-12-11
9901365,1,0,1,0.0,8.211974124807393e-20,1999-01-21
9905366,1,0,1,0.0,8.211974124807393e-20,1999-05-17
9912376,1,0,1,0.0,8.211974124807393e-20,1999-12-16
6135,1,1,0,0.0,5.968462793910005e-16,2000-06-13
10007,1,1,0,0.0,5.968462793910005e-16,2000-10-02
11086,1,1,0,0.0,5.968462793910005e-16,2000-11-07
12086,1,1,0,0.0,5.968462793910005e-16,2000-12-07
9603202,1,1,0,0.0,5.968462793910005e-16,1996-03-02
9605259,1,1,0,0.0,5.968462793910005e-16,1996-05-08
9808385,1,1,0,0.0,5.968462793910005e-16,1998-08-22
9912322,1,1,0,0.0,5.968462793910005e-16,1999-12-13
102310,1,0,1,0.0,8.211974124807393e-20,2001-02-26
9811313,1,0,1,0.0,8.211974124807393e-20,1998-11-12
9906268,1,0,1,0.0,8.211974124807393e-20,1999-06-07
9711410,1,0,1,0.0,8.211974124807393e-20,1997-11-20
9211262,2,2,0,0.0,1.4195300591883376e-14,1992-11-17
9211310,1,1,0,0.0,1.41176153166627e-14,1992-11-25
9301225,1,1,0,0.0,1.41176153166627e-14,1993-01-10
9301252,1,1,0,0.0,1.41176153166627e-14,1993-01-20
9301265,1,1,0,0.0,1.41176153166627e-14,1993-01-25
9302284,1,1,0,0.0,1.41176153166627e-14,1993-02-20
9303215,2,2,0,0.0,1.5282894444972864e-14,1993-03-03
9303293,1,1,0,0.0,1.41176153166627e-14,1993-03-23
9303294,1,1,0,0.0,1.41176153166627e-14,1993-03-23
9304209,1,1,0,0.0,1.41176153166627e-14,1993-04-03
9304248,2,2,0,0.0,1.4195300591883376e-14,1993-04-13
9304290,1,1,0,0.0,1.41176153166627e-14,1993-04-22
9304308,1,1,0,0.0,1.41176153166627e-14,1993-04-27
9306319,1,1,0,0.0,1.41176153166627e-14,1993-06-25
9309216,1,1,0,0.0,1.41176153166627e-14,1993-09-02
9309258,1,1,0,0.0,1.41176153166627e-14,1993-09-13
9309294,2,2,0,0.0,1.4121146465536367e-14,1993-09-20
9310244,1,1,0,0.0,1.41176153166627e-14,1993-10-07
9310340,1,1,0,0.0,1.41176153166627e-14,1993-10-22
9312201,1,1,0,0.0,1.41176153166627e-14,1993-11-30
9312347,1,1,0,0.0,1.41176153166627e-14,1993-12-28
9402268,2,2,0,0.0,1.9070683933988444e-13,1994-02-10
9402278,1,1,0,0.0,1.41176153166627e-14,1994-02-14
9402358,1,1,0,0.0,1.41176153166627e-14,1994-02-26
9403362,2,2,0,0.0,1.4121146465536367e-14,1994-03-24
9404244,1,1,0,0.0,1.41176153166627e-14,1994-04-08
9404247,1,1,0,0.0,1.41176153166627e-14,1994-04-10
9404280,1,1,0,0.0,1.41176153166627e-14,1994-04-18
9404343,1,1,0,0.0,1.41176153166627e-14,1994-04-26
9404359,1,1,0,0.0,1.41176153166627e-14,1994-05-01
9405329,1,1,0,0.0,1.41176153166627e-14,1994-05-19
9405401,1,1,0,0.0,1.41176153166627e-14,1994-05-27
9406228,1,1,0,0.0,1.41176153166627e-14,1994-06-03
9406374,2,2,0,0.0,1.9070683933988444e-13,1994-06-22
9406395,1,1,0,0.0,1.41176153166627e-14,1994-06-26
9407246,1,1,0,0.0,1.41176153166627e-14,1994-06-21
9409357,1,1,0,0.0,1.41176153166627e-14,1994-09-19
9409412,1,1,0,0.0,1.41176153166627e-14,1994-09-24
9409458,3,3,0,0.0,1.907845246151051e-13,1994-09-30
9410342,1,1,0,0.0,1.41176153166627e-14,1994-10-21
9410354,1,1,0,0.0,1.41176153166627e-14,1994-10-23
9411201,1,1,0,0.0,1.41176153166627e-14,1994-11-01
9411357,1,1,0,0.0,1.41176153166627e-14,1994-11-22
9501339,1,1,0,0.0,1.41176153166627e-14,1995-01-18
9502206,2,2,0,0.0,1.5233458360741524e-14,1995-02-01
9502210,1,1,0,0.0,1.41176153166627e-14,1995-02-01
9505233,1,1,0,0.0,1.41176153166627e-14,1995-05-04
9505347,1,1,0,0.0,1.41176153166627e-14,1995-05-21
9510399,1,1,0,0.0,1.41176153166627e-14,1995-10-24
9710368,1,0,1,0.0,8.211974124807393e-20,1997-10-15
9612292,1,0,1,0.0,8.211974124807393e-20,1996-12-08
7170,1,0,1,0.0,8.211974124807393e-20,2000-07-17
9604312,1,0,1,0.0,8.211974124807393e-20,1996-04-12
9801417,1,0,1,0.0,8.211974124807393e-20,1998-01-27
112340,1,0,1,0.0,8.211974124807393e-20,2001-12-27
103343,1,0,1,0.0,8.211974124807393e-20,2001-03-30
10296,1,0,1,0.0,8.211974124807393e-20,2000-10-25
3203,1,1,0,0.0,9.437709806624386e-14,2000-03-21
6321,1,1,0,0.0,9.437709806624386e-14,2000-06-28
7031,1,1,0,0.0,9.437709806624386e-14,2000-07-04
9602323,1,1,0,0.0,9.437709806624386e-14,1996-02-16
9607217,1,1,0,0.0,9.437709806624386e-14,1996-07-02
9609381,1,1,0,0.0,9.437709806624386e-14,1996-09-17
9704207,2,2,0,0.0,9.50480163522406e-14,1997-04-01
9801260,2,2,0,0.0,9.50480163522406e-14,1998-01-10
9801262,2,2,0,0.0,9.50480163522406e-14,1998-01-12
9802299,1,1,0,0.0,9.437709806624386e-14,1998-02-11
9806305,1,1,0,0.0,9.437709806624386e-14,1998-06-08
9812448,2,2,0,0.0,9.50480163522406e-14,1998-12-20
9902451,1,1,0,0.0,9.437709806624386e-14,1999-02-24
102209,1,0,1,0.0,8.211974124807393e-20,2001-02-16
12136,2,0,2,0.0,8.211974124807393e-20,2000-12-12
8214,1,0,1,0.0,8.211974124807393e-20,2000-08-21
10150,2,0,2,0.0,8.211974124807393e-20,2000-10-15
102121,1,0,1,0.0,8.211974124807393e-20,2001-02-09
102224,1,0,1,0.0,8.211974124807393e-20,2001-02-18
11314,1,0,1,0.0,8.211974124807393e-20,2000-11-25
9905577,1,0,1,0.0,8.211974124807393e-20,1999-05-31
9908458,1,0,1,0.0,8.211974124807393e-20,1999-08-25
101262,1,0,1,0.0,8.211974124807393e-20,2001-01-23
9803257,1,0,1,0.0,8.211974124807393e-20,1998-03-05
9903218,1,0,1,0.0,8.211974124807393e-20,1999-03-01
9806301,1,0,1,0.0,8.211974124807393e-20,1998-06-08
10008,1,0,1,0.0,8.211974124807393e-20,2000-10-02
10107,1,0,1,0.0,8.211974124807393e-20,2000-10-11
1017,1,0,1,0.0,8.211974124807393e-20,2000-01-03
12092,1,0,1,0.0,8.211974124807393e-20,2000-12-07
106336,1,0,1,0.0,8.211974124807393e-20,2001-06-28
11177,1,0,1,0.0,8.211974124807393e-20,2000-11-14
9608329,2,1,1,2.2647621669244415e-05,2.2607564765594756e-16,1996-08-14
101300,1,0,1,0.0,8.211974124807393e-20,2001-01-26
112126,1,0,1,0.0,8.211974124807393e-20,2001-12-08
9806266,1,0,1,0.0,8.211974124807393e-20,1998-06-04
9207245,1,1,0,0.0,3.002297740029582e-16,1992-07-17
9412278,1,1,0,0.0,3.002297740029582e-16,1994-12-12
9505319,1,1,0,0.0,3.002297740029582e-16,1995-05-16
9506380,1,1,0,0.0,3.002297740029582e-16,1995-06-21
9606387,1,1,0,0.0,3.002297740029582e-16,1996-06-20
9608336,1,1,0,0.0,3.002297740029582e-16,1996-08-15
9609431,1,1,0,0.0,3.002297740029582e-16,1996-09-22
9610319,1,1,0,0.0,3.002297740029582e-16,1996-10-10
9612478,1,1,0,0.0,3.002297740029582e-16,1996-12-27
9710534,1,0,1,0.0,8.211974124807393e-20,1997-10-29
12259,1,0,1,0.0,8.211974124807393e-20,2000-12-19
6027,1,0,1,0.0,8.211974124807393e-20,2000-06-02
11111,24,2,22,5.686205440561366e-06,7.144417488582434e-18,2000-11-08
2077,1,1,0,0.0,1.519215213089368e-16,2000-02-07
3142,1,1,0,0.0,1.519215213089368e-16,2000-03-15
7238,2,1,1,0.0,1.519215213089368e-16,2000-07-21
8230,1,1,0,0.0,1.519215213089368e-16,2000-08-22
11032,1,1,0,0.0,1.519215213089368e-16,2000-11-02
9405388,1,1,0,0.0,1.519215213089368e-16,1994-05-26
9503234,1,1,0,0.0,1.519215213089368e-16,1995-03-04
9506338,1,1,0,0.0,1.519215213089368e-16,1995-06-15
9512309,1,1,0,0.0,1.519215213089368e-16,1995-12-14
9701320,1,1,0,0.0,1.519215213089368e-16,1997-01-17
9702287,2,2,0,0.0,1.5545267018260395e-16,1997-02-07
9708271,1,1,0,0.0,1.519215213089368e-16,1997-08-07
9803449,1,1,0,0.0,1.519215213089368e-16,1998-03-25
9806404,1,1,0,0.0,1.519215213089368e-16,1998-06-18
9808467,2,2,0,0.0,3.7791504922363627e-16,1998-08-28
9810284,1,1,0,0.0,1.519215213089368e-16,1998-10-08
9904492,1,1,0,0.0,1.519215213089368e-16,1999-04-29
9905555,1,1,0,0.0,1.519215213089368e-16,1999-05-31
9911379,1,1,0,0.0,1.519215213089368e-16,1999-11-16
9909524,1,0,1,0.0,8.211974124807393e-20,1999-09-28
7194,1,0,1,0.0,8.211974124807393e-20,2000-07-18
5258,2,0,2,0.0,8.211974124807393e-20,2000-05-25
9412324,1,1,0,0.0,6.500992140431095e-05,1994-12-19
9602353,1,1,0,0.0,6.500992140431095e-05,1996-02-20
9612269,1,1,0,0.0,6.500992140431095e-05,1996-12-05
9704287,1,1,0,0.0,6.500992140431095e-05,1997-04-10
9704423,1,1,0,0.0,6.500992140431095e-05,1997-04-28
9803479,1,1,0,0.0,6.500992140431095e-05,1998-03-27
9902328,1,1,0,0.0,6.500992140431095e-05,1999-02-11
9907363,1,1,0,0.0,6.500992140431095e-05,1999-07-14
9908341,1,1,0,0.0,6.500992140431095e-05,1999-08-12
9908432,1,1,0,0.0,6.500992140431095e-05,1999-08-22
9911243,1,0,1,0.0,8.211974124807393e-20,1999-11-04
3081,1,1,0,0.0,1.0354984688533647e-11,2000-03-09
3086,1,1,0,0.0,1.0354984688533647e-11,2000-03-09
3187,1,1,0,0.0,1.0354984688533647e-11,2000-03-20
5204,2,2,0,0.0,1.5492707427550926e-11,2000-05-20
7320,1,1,0,0.0,1.0354984688533647e-11,2000-07-27
8069,1,1,0,0.0,1.0354984688533647e-11,2000-08-08
10058,1,1,0,0.0,1.0354984688533647e-11,2000-10-06
9308271,2,2,0,0.0,1.0355655606819644e-11,1993-08-13
9408322,1,1,0,0.0,1.0354984688533647e-11,1994-08-19
9504371,1,1,0,0.0,1.0354984688533647e-11,1995-04-24
9507244,1,1,0,0.0,1.0354984688533647e-11,1995-07-06
9508258,1,1,0,0.0,1.0354984688533647e-11,1995-08-08
9606237,1,1,0,0.0,1.0354984688533647e-11,1996-06-04
9608251,1,1,0,0.0,1.0354984688533647e-11,1996-08-07
9801271,2,2,0,0.0,1.5492707427550926e-11,1998-01-12
9803290,1,1,0,0.0,1.0354984688533647e-11,1998-03-09
9810442,3,3,0,0.0,1.5698760557776023e-11,1998-10-21
9812397,2,2,0,0.0,1.5492707427550926e-11,1998-12-16
9903448,1,1,0,0.0,1.0354984688533647e-11,1999-03-22
9903535,1,1,0,0.0,1.0354984688533647e-11,1999-03-30
9903544,1,1,0,0.0,1.0354984688533647e-11,1999-03-31
9904283,1,1,0,0.0,1.0354984688533647e-11,1999-04-09
9909325,1,1,0,0.0,1.0354984688533647e-11,1999-09-10
9911337,1,1,0,0.0,1.0354984688533647e-11,1999-11-12
104008,1,0,1,0.0,8.211974124807393e-20,2001-04-02
9021,1,0,1,0.0,8.211974124807393e-20,2000-09-04
101212,1,0,1,0.0,8.211974124807393e-20,2001-01-19
9206205,1,1,0,0.0,3.976427567834019e-13,1992-06-03
9207218,1,1,0,0.0,3.976427567834019e-13,1992-07-07
9303241,1,1,0,0.0,3.976427567834019e-13,1993-03-10
9303320,1,1,0,0.0,3.976427567834019e-13,1993-03-31
9304299,1,1,0,0.0,3.976427567834019e-13,1993-04-26
9304307,1,1,0,0.0,3.976427567834019e-13,1993-04-27
9308333,1,1,0,0.0,3.976427567834019e-13,1993-08-24
9308363,1,1,0,0.0,3.976427567834019e-13,1993-08-30
9311281,1,1,0,0.0,3.976427567834019e-13,1993-11-11
9411273,1,1,0,0.0,3.976427567834019e-13,1994-11-11
9411276,1,1,0,0.0,3.976427567834019e-13,1994-11-11
9412322,1,1,0,0.0,3.976427567834019e-13,1994-12-19
9502397,1,1,0,0.0,3.976427567834019e-13,1995-02-27
9505248,2,2,0,0.0,3.9838782919574576e-13,1995-05-08
9508296,1,1,0,0.0,3.976427567834019e-13,1995-08-14
9509410,2,2,0,0.0,3.9786875031131666e-13,1995-09-28
9602410,1,0,1,0.0,8.211974124807393e-20,1996-02-27
9806346,1,0,1,0.0,8.211974124807393e-20,1998-06-11
9511409,1,0,1,0.0,8.211974124807393e-20,1995-11-24
9512395,1,0,1,0.0,8.211974124807393e-20,1995-12-21
1088,1,0,1,0.0,8.211974124807393e-20,2000-01-11
9606324,1,0,1,0.0,8.211974124807393e-20,1996-06-13
9211249,1,1,0,0.0,1.7658930614296302e-13,1992-11-16
9211260,1,1,0,0.0,1.7658930614296302e-13,1992-11-17
9211261,1,1,0,0.0,1.7658930614296302e-13,1992-11-17
9212211,1,1,0,0.0,1.7658930614296302e-13,1992-12-02
9302202,1,1,0,0.0,1.7658930614296302e-13,1993-02-02
9302234,1,1,0,0.0,1.7658930614296302e-13,1993-02-08
9303231,1,1,0,0.0,1.7658930614296302e-13,1993-03-08
9303280,1,1,0,0.0,1.7658930614296302e-13,1993-03-18
9303291,1,1,0,0.0,1.7658930614296302e-13,1993-03-23
9304277,1,1,0,0.0,1.7658930614296302e-13,1993-04-20
9304295,1,1,0,0.0,1.7658930614296302e-13,1993-04-23
9307249,1,1,0,0.0,1.7658930614296302e-13,1993-07-12
9307301,1,1,0,0.0,1.7658930614296302e-13,1993-07-19
9307342,1,1,0,0.0,1.7658930614296302e-13,1993-07-27
9308266,1,1,0,0.0,1.7658930614296302e-13,1993-08-12
9309293,1,1,0,0.0,1.7658930614296302e-13,1993-09-20
9401346,1,1,0,0.0,1.7658930614296302e-13,1994-01-27
9402238,1,1,0,0.0,1.7658930614296302e-13,1994-02-07
9403202,1,1,0,0.0,1.7658930614296302e-13,1994-03-01
9404253,1,1,0,0.0,1.7658930614296302e-13,1994-04-11
9404347,1,1,0,0.0,1.7658930614296302e-13,1994-04-27
9406337,1,1,0,0.0,1.7658930614296302e-13,1994-06-17
9406419,1,1,0,0.0,1.7658930614296302e-13,1994-06-29
9408319,1,1,0,0.0,1.7658930614296302e-13,1994-08-18
9408320,1,1,0,0.0,1.7658930614296302e-13,1994-08-18
9501320,1,1,0,0.0,1.7658930614296302e-13,1995-01-17
9505308,2,2,0,0.0,1.7681529967087775e-13,1995-05-15
9509207,1,1,0,0.0,1.7658930614296302e-13,1995-09-01
9510224,2,2,0,0.0,1.7681529967087775e-13,1995-10-04
9510402,1,1,0,0.0,1.7658930614296302e-13,1995-10-25
9612362,2,0,2,0.0,8.211974124807393e-20,1996-12-14
3186,1,1,0,0.0,7.451545320850212e-16,2000-03-17
6122,1,1,0,0.0,7.451545320850212e-16,2000-06-12
9337,1,1,0,0.0,7.451545320850212e-16,2000-09-28
10003,1,1,0,0.0,7.451545320850212e-16,2000-10-02
104034,1,1,0,0.0,7.451545320850212e-16,2001-04-03
105005,1,1,0,0.0,7.451545320850212e-16,2001-05-01
105267,1,1,0,0.0,7.451545320850212e-16,2001-05-25
106025,1,1,0,0.0,7.451545320850212e-16,2001-06-03
106148,1,1,0,0.0,7.451545320850212e-16,2001-06-14
106352,1,1,0,0.0,7.451545320850212e-16,2001-06-29
107069,5,1,4,0.00018194920680099494,7.451545320850212e-16,2001-07-06
107097,1,1,0,0.0,7.451545320850212e-16,2001-07-09
108122,1,1,0,0.0,7.451545320850212e-16,2001-08-15
108250,2,1,1,9.50637738141616e-05,7.451545320850212e-16,2001-08-30
109058,1,1,0,0.0,7.451545320850212e-16,2001-09-07
110032,1,1,0,0.0,7.451545320850212e-16,2001-10-02
110341,1,1,0,0.0,7.451545320850212e-16,2001-10-25
111058,1,1,0,0.0,7.451545320850212e-16,2001-11-06
111059,1,1,0,0.0,7.451545320850212e-16,2001-11-06
112102,1,1,0,0.0,7.451545320850212e-16,2000-02-12
112102,1,1,0,0.0,7.451545320850212e-16,2001-12-06
112117,1,1,0,0.0,7.451545320850212e-16,2001-12-07
112255,1,1,0,0.0,7.451545320850212e-16,2001-12-19
201001,1,1,0,0.0,7.451545320850212e-16,2001-12-31
201081,1,1,0,0.0,7.451545320850212e-16,2002-01-10
201297,1,1,0,0.0,7.451545320850212e-16,2002-01-31
202275,1,1,0,0.0,7.451545320850212e-16,2002-02-28
9406390,1,1,0,0.0,7.451545320850212e-16,1994-06-24
9409301,1,1,0,0.0,7.451545320850212e-16,1994-09-13
9503271,1,1,0,0.0,7.451545320850212e-16,1995-03-08
9503463,1,1,0,0.0,7.451545320850212e-16,1995-03-30
9505251,1,1,0,0.0,7.451545320850212e-16,1995-05-08
9511388,1,1,0,0.0,7.451545320850212e-16,1995-11-22
9601310,1,1,0,0.0,7.451545320850212e-16,1996-01-23
9708227,1,1,0,0.0,7.451545320850212e-16,1997-08-04
9710473,1,1,0,0.0,7.451545320850212e-16,1997-10-25
9805303,1,1,0,0.0,7.451545320850212e-16,1998-05-12
9805470,1,1,0,0.0,7.451545320850212e-16,1998-05-26
9907555,1,1,0,0.0,7.451545320850212e-16,1999-07-29
9908443,1,1,0,0.0,7.451545320850212e-16,1999-08-23
9910205,1,1,0,0.0,7.451545320850212e-16,1999-10-01
103064,2,1,1,1.5968710466027951e-06,2.0605321234484194e-13,2001-03-06
103202,1,1,0,0.0,2.0605321234484194e-13,2001-03-19
104254,2,1,1,1.5968710466027951e-06,2.0605321234484194e-13,2001-04-25
9504415,1,1,0,0.0,2.0605321234484194e-13,1995-04-27
9507282,2,2,0,0.0,2.0627920587275662e-13,1995-07-11
9507462,1,1,0,0.0,2.0605321234484194e-13,1995-07-31
9607394,2,2,0,0.0,2.0627920587275662e-13,1996-07-22
9704390,1,1,0,0.0,2.0605321234484194e-13,1997-04-23
9904367,1,1,0,0.0,2.0605321234484194e-13,1999-04-16
9911293,2,2,0,0.0,5.343775951362117e-12,1999-11-10
9911323,2,2,0,0.0,5.343775951362117e-12,1999-11-11
107182,1,0,1,0.0,8.211974124807393e-20,2001-07-17
9912344,1,0,1,0.0,8.211974124807393e-20,1999-12-15
9509329,1,0,1,0.0,8.211974124807393e-20,1995-09-19
9909312,1,0,1,0.0,8.211974124807393e-20,1999-09-09
9911399,1,0,1,0.0,8.211974124807393e-20,1999-11-18
101309,1,0,1,0.0,8.211974124807393e-20,2001-01-28
1189,1,0,1,0.0,8.211974124807393e-20,2000-01-18
9908379,34,2,32,6.220805952067135e-06,7.144417488582434e-18,1999-08-17
9907270,1,0,1,0.0,8.211974124807393e-20,1999-07-07
110075,1,0,1,0.0,8.211974124807393e-20,2001-10-04
106192,23,9,14,3.7130435526400716e-05,3.186245960425262e-17,2001-06-18
110062,2,0,2,0.0,8.211974124807393e-20,2001-10-04
108267,1,0,1,0.0,8.211974124807393e-20,2001-08-31
101237,1,0,1,0.0,8.211974124807393e-20,2001-01-22
5214,1,0,1,0.0,8.211974124807393e-20,2000-05-22
9911206,1,0,1,0.0,8.211974124807393e-20,1999-11-02
2034,1,0,1,0.0,8.211974124807393e-20,2000-02-03
7307,1,0,1,0.0,8.211974124807393e-20,2000-07-26
9612307,1,0,1,0.0,8.211974124807393e-20,1996-12-09
9703387,2,0,2,0.0,8.211974124807393e-20,1997-03-21
9907291,1,0,1,0.0,8.211974124807393e-20,1999-07-09
9904297,1,0,1,0.0,8.211974124807393e-20,1999-04-11
9812393,1,0,1,0.0,8.211974124807393e-20,1998-12-16
9810343,1,0,1,0.0,8.211974124807393e-20,1998-10-13
9909260,2,0,2,0.0,8.211974124807393e-20,1999-09-06
104115,1,0,1,0.0,8.211974124807393e-20,2001-04-11
9903382,1,0,1,0.0,8.211974124807393e-20,1999-03-17
9505317,1,0,1,0.0,8.211974124807393e-20,1995-05-16
10161,2,0,2,0.0,8.211974124807393e-20,2000-10-16
9903449,1,0,1,0.0,8.211974124807393e-20,1999-03-22
7061,1,0,1,0.0,8.211974124807393e-20,2000-07-06
6091,1,0,1,0.0,8.211974124807393e-20,2000-06-09
107083,1,0,1,0.0,8.211974124807393e-20,2001-07-09
9805244,1,0,1,0.0,8.211974124807393e-20,1998-05-07
7017,1,0,1,0.0,8.211974124807393e-20,2000-07-03
201009,1,0,1,0.0,8.211974124807393e-20,2002-01-02
112114,1,0,1,0.0,8.211974124807393e-20,2001-12-07
7137,1,0,1,0.0,8.211974124807393e-20,2000-07-13
2216,1,0,1,0.0,8.211974124807393e-20,2000-02-21
9811294,1,0,1,0.0,8.211974124807393e-20,1998-11-10
9706421,1,0,1,0.0,8.211974124807393e-20,1997-06-20
9908530,1,0,1,0.0,8.211974124807393e-20,1999-08-31
4032,1,0,1,0.0,8.211974124807393e-20,2000-04-04
9611451,2,1,1,1.1664011160125879e-05,2.2607564765594756e-16,1996-11-27
9805230,1,0,1,0.0,8.211974124807393e-20,1998-05-06
9712236,1,0,1,0.0,8.211974124807393e-20,1997-12-02
9611283,1,0,1,0.0,8.211974124807393e-20,1996-11-08
9611215,1,0,1,0.0,8.211974124807393e-20,1996-11-02
9508250,1,0,1,0.0,8.211974124807393e-20,1995-08-07
103095,2,0,2,0.0,8.211974124807393e-20,2001-03-09
9612361,2,0,2,0.0,8.211974124807393e-20,1996-12-14
9511392,1,0,1,0.0,8.211974124807393e-20,1995-11-22
8085,2,0,2,0.0,8.211974124807393e-20,2000-08-09
104104,1,0,1,0.0,8.211974124807393e-20,2001-04-11
4059,1,1,0,0.0,6.710004057380109e-16,2000-04-06
101335,1,1,0,0.0,6.710004057380109e-16,2001-01-30
9603249,1,1,0,0.0,6.710004057380109e-16,1996-03-07
9705477,2,2,0,0.0,1.1194563126937428e-15,1997-05-29
9706344,1,1,0,0.0,6.710004057380109e-16,1997-06-12
9805380,1,1,0,0.0,6.710004057380109e-16,1998-05-19
9903520,1,1,0,0.0,6.710004057380109e-16,1999-03-29
9912379,1,1,0,0.0,6.710004057380109e-16,1999-12-16
9911452,1,0,1,0.0,8.211974124807393e-20,1999-11-23
4137,1,0,1,0.0,8.211974124807393e-20,2000-04-14
108262,1,0,1,0.0,8.211974124807393e-20,2001-08-30
9302224,1,1,0,0.0,1.1159251638200775e-15,1993-02-05
9307322,1,1,0,0.0,1.1159251638200775e-15,1993-07-22
9308309,1,1,0,0.0,1.1159251638200775e-15,1993-08-20
9503306,1,1,0,0.0,1.1159251638200775e-15,1995-03-10
9505326,1,1,0,0.0,1.1159251638200775e-15,1995-05-17
9506359,2,2,0,0.0,1.860997576163851e-15,1995-06-19
9511275,1,1,0,0.0,1.1159251638200775e-15,1995-11-09
9603301,1,1,0,0.0,1.1159251638200775e-15,1996-03-13
9609323,1,1,0,0.0,1.1159251638200775e-15,1996-09-11
9611251,1,1,0,0.0,1.1159251638200775e-15,1996-11-06
9704232,1,1,0,0.0,1.1159251638200775e-15,1997-04-04
9709505,1,1,0,0.0,1.1159251638200775e-15,1997-09-30
9712300,1,1,0,0.0,1.1159251638200775e-15,1997-12-08
9901317,1,0,1,0.0,8.211974124807393e-20,1999-01-14
111333,1,0,1,0.0,8.211974124807393e-20,2001-11-26
10312,1,1,0,0.0,5.137722821137015e-12,2000-10-26
9911517,1,1,0,0.0,5.137722821137015e-12,1999-11-29
101143,1,0,1,0.0,8.211974124807393e-20,2001-01-14
6162,1,0,1,0.0,8.211974124807393e-20,2000-06-15
6040,1,0,1,0.0,8.211974124807393e-20,2000-06-04
9610222,2,0,2,0.0,8.211974124807393e-20,1996-10-02
112062,1,0,1,0.0,8.211974124807393e-20,2000-02-26
112062,1,0,1,0.0,8.211974124807393e-20,2001-12-04
1003,1,0,1,0.0,8.211974124807393e-20,2000-01-01
7006,1,0,1,0.0,8.211974124807393e-20,2000-07-03
9710503,1,0,1,0.0,8.211974124807393e-20,1997-10-28
112281,1,0,1,0.0,8.211974124807393e-20,2001-12-20
9808433,1,0,1,0.0,8.211974124807393e-20,1998-08-27
112045,1,0,1,0.0,8.211974124807393e-20,2000-02-17
112045,1,0,1,0.0,8.211974124807393e-20,2001-12-04
4190,2,0,2,0.0,8.211974124807393e-20,2000-04-20
9901431,1,0,1,0.0,8.211974124807393e-20,1999-01-27
106275,1,0,1,0.0,8.211974124807393e-20,2001-06-25
203061,1,0,1,0.0,8.211974124807393e-20,2002-03-06
9903366,1,0,1,0.0,8.211974124807393e-20,1999-03-16
9903543,1,0,1,0.0,8.211974124807393e-20,1999-03-31
9908306,1,0,1,0.0,8.211974124807393e-20,1999-08-09
9504433,1,0,1,0.0,8.211974124807393e-20,1995-04-30
9610344,1,0,1,0.0,8.211974124807393e-20,1996-10-14
9133,1,0,1,0.0,8.211974124807393e-20,2000-09-11
9906264,1,0,1,0.0,8.211974124807393e-20,1999-06-05
106351,2,0,2,0.0,8.211974124807393e-20,2001-06-29
110363,2,0,2,0.0,8.211974124807393e-20,2001-10-28
111093,1,0,1,0.0,8.211974124807393e-20,2000-01-16
111093,1,0,1,0.0,8.211974124807393e-20,2001-11-08
9802218,1,0,1,0.0,8.211974124807393e-20,1998-02-02
4007,1,0,1,0.0,8.211974124807393e-20,2000-04-03
9406373,1,1,0,0.0,1.6833348007632943e-13,1994-06-23
9412265,1,1,0,0.0,1.6833348007632943e-13,1994-12-09
9504219,1,1,0,0.0,1.6833348007632943e-13,1995-04-04
9512336,1,1,0,0.0,1.6833348007632943e-13,1995-12-18
9701418,2,2,0,0.0,1.6833701122520306e-13,1997-01-30
9705290,1,1,0,0.0,1.6833348007632943e-13,1997-05-12
9705318,1,1,0,0.0,1.6833348007632943e-13,1997-05-14
9705460,1,1,0,0.0,1.6833348007632943e-13,1997-05-29
9706209,1,1,0,0.0,1.6833348007632943e-13,1997-06-02
9706457,1,1,0,0.0,1.6833348007632943e-13,1997-06-23
9710257,1,1,0,0.0,1.6833348007632943e-13,1997-10-06
9710487,1,1,0,0.0,1.6833348007632943e-13,1997-10-27
201300,1,0,1,0.0,8.211974124807393e-20,2002-01-31
9809287,1,0,1,0.0,8.211974124807393e-20,1998-09-07
9901280,1,0,1,0.0,8.211974124807393e-20,1999-01-12
107204,1,0,1,0.0,8.211974124807393e-20,2001-07-19
9209296,1,1,0,0.0,7.451545320850212e-16,1992-09-30
9301240,1,1,0,0.0,7.451545320850212e-16,1993-01-15
9309316,1,1,0,0.0,7.451545320850212e-16,1993-09-23
9310374,1,1,0,0.0,7.451545320850212e-16,1993-10-29
9404268,1,1,0,0.0,7.451545320850212e-16,1994-04-14
9606388,1,1,0,0.0,7.451545320850212e-16,1996-06-20
9610540,1,1,0,0.0,7.451545320850212e-16,1996-10-30
9612447,1,1,0,0.0,7.451545320850212e-16,1996-12-22
9702412,1,1,0,0.0,7.451545320850212e-16,1997-02-24
9808224,1,1,0,0.0,7.451545320850212e-16,1998-08-04
9810371,1,1,0,0.0,7.451545320850212e-16,1998-10-15
9901254,1,1,0,0.0,7.451545320850212e-16,1999-01-08
9901260,1,1,0,0.0,7.451545320850212e-16,1999-01-10
9905549,1,1,0,0.0,7.451545320850212e-16,1999-05-30
9907466,1,1,0,0.0,7.451545320850212e-16,1999-07-23
9907499,1,1,0,0.0,7.451545320850212e-16,1999-07-26
9909443,1,1,0,0.0,7.451545320850212e-16,1999-09-20
9910320,1,1,0,0.0,7.451545320850212e-16,1999-10-13
9608273,1,0,1,0.0,8.211974124807393e-20,1996-08-08
9807256,1,0,1,0.0,8.211974124807393e-20,1998-07-06
103039,1,0,1,0.0,8.211974124807393e-20,2001-03-03
5116,1,0,1,0.0,8.211974124807393e-20,2000-05-12
112130,1,0,1,0.0,8.211974124807393e-20,2001-12-10
110136,1,0,1,0.0,8.211974124807393e-20,2001-10-10
9405389,1,1,0,0.0,2.2607564765594756e-16,1994-05-27
9503303,1,1,0,0.0,2.2607564765594756e-16,1995-03-11
9507453,2,2,0,0.0,3.7791504922363627e-16,1995-07-30
9606342,1,1,0,0.0,2.2607564765594756e-16,1996-06-15
9606423,1,1,0,0.0,2.2607564765594756e-16,1996-06-24
9707273,1,1,0,0.0,2.2607564765594756e-16,1997-07-07
9802358,1,1,0,0.0,2.2607564765594756e-16,1998-02-19
9806213,1,1,0,0.0,2.2607564765594756e-16,1998-06-01
9811412,1,1,0,0.0,2.2607564765594756e-16,1998-11-19
9901453,1,1,0,0.0,2.2607564765594756e-16,1999-01-29
9806258,1,0,1,0.0,8.211974124807393e-20,1998-06-04
9901323,1,0,1,0.0,8.211974124807393e-20,1999-01-15
110124,1,0,1,0.0,8.211974124807393e-20,2001-10-09
9512312,1,0,1,0.0,8.211974124807393e-20,1995-12-14
9907207,1,0,1,0.0,8.211974124807393e-20,1999-07-01
9901237,2,0,2,0.0,8.211974124807393e-20,1999-01-06
101045,2,1,1,2.7216026040293718e-06,7.7767394961926e-17,2001-01-05
102273,1,0,1,0.0,8.211974124807393e-20,2001-02-22
107131,1,0,1,0.0,8.211974124807393e-20,2001-07-11
5276,1,0,1,0.0,8.211974124807393e-20,2000-05-27
109155,1,0,1,0.0,8.211974124807393e-20,2001-09-18
2086,1,0,1,0.0,8.211974124807393e-20,2000-02-08
103192,1,0,1,0.0,8.211974124807393e-20,2001-03-19
9709431,1,0,1,0.0,8.211974124807393e-20,1997-09-23
8210,1,0,1,0.0,8.211974124807393e-20,2000-08-18
107279,1,0,1,0.0,8.211974124807393e-20,2001-07-26
103169,1,0,1,0.0,8.211974124807393e-20,2001-03-15
102318,1,0,1,0.0,8.211974124807393e-20,2001-02-26
9907347,1,0,1,0.0,8.211974124807393e-20,1999-07-14
9905500,1,0,1,0.0,8.211974124807393e-20,1999-05-27
9601230,3,1,2,3.3048031620356655e-05,3.002297740029582e-16,1996-01-09
9709450,1,0,1,0.0,8.211974124807393e-20,1997-09-25
9910275,2,1,1,5.832005580062939e-06,1.165361248051417e-15,1999-10-08
103243,1,0,1,0.0,8.211974124807393e-20,2001-03-22
9712334,1,0,1,0.0,8.211974124807393e-20,1997-12-10
9810493,1,0,1,0.0,8.211974124807393e-20,1998-10-27
9707494,1,0,1,0.0,8.211974124807393e-20,1997-07-28
6222,1,0,1,0.0,8.211974124807393e-20,2000-06-19
9701264,1,0,1,0.0,8.211974124807393e-20,1997-01-10
105338,1,0,1,0.0,8.211974124807393e-20,2001-05-31
9807494,2,0,2,0.0,8.211974124807393e-20,1998-07-25
9904321,1,0,1,0.0,8.211974124807393e-20,1999-04-13
9705471,1,0,1,0.0,8.211974124807393e-20,1997-05-30
1283,1,0,1,0.0,8.211974124807393e-20,2000-01-27
111366,1,0,1,0.0,8.211974124807393e-20,2001-11-28
9803246,1,0,1,0.0,8.211974124807393e-20,1998-03-04
9903345,1,0,1,0.0,8.211974124807393e-20,1999-03-15
9609283,20,4,16,6.220805952067135e-06,1.4206715235916795e-17,1996-09-07
108095,1,0,1,0.0,8.211974124807393e-20,2001-08-10
9809598,1,0,1,0.0,8.211974124807393e-20,1998-09-30
110092,1,0,1,0.0,8.211974124807393e-20,2001-10-05
9910417,1,0,1,0.0,8.211974124807393e-20,1999-10-20
6271,1,0,1,0.0,8.211974124807393e-20,2000-06-23
5019,1,0,1,0.0,8.211974124807393e-20,2000-05-03
9905412,1,0,1,0.0,8.211974124807393e-20,1999-05-20
5122,1,0,1,0.0,8.211974124807393e-20,2000-05-12
9911347,1,0,1,0.0,8.211974124807393e-20,1999-11-13
9702310,1,0,1,0.0,8.211974124807393e-20,1997-02-12
9610363,1,0,1,0.0,8.211974124807393e-20,1996-10-15
3205,1,0,1,0.0,8.211974124807393e-20,2000-03-21
9604257,21,9,12,1.0497610044113291e-05,3.186245960425262e-17,1996-04-06
9808409,1,0,1,0.0,8.211974124807393e-20,1998-08-25
9207279,1,1,0,0.0,6.710004057380109e-16,1992-08-01
9211228,1,1,0,0.0,6.710004057380109e-16,1992-11-07
9304266,1,1,0,0.0,6.710004057380109e-16,1993-04-18
9308292,1,1,0,0.0,6.710004057380109e-16,1993-08-18
9308325,1,1,0,0.0,6.710004057380109e-16,1993-08-24
9309252,1,1,0,0.0,6.710004057380109e-16,1993-09-09
9401332,1,1,0,0.0,6.710004057380109e-16,1994-01-26
9407248,1,1,0,0.0,6.710004057380109e-16,1994-07-07
9411239,1,1,0,0.0,6.710004057380109e-16,1994-11-08
9504395,1,1,0,0.0,6.710004057380109e-16,1995-04-26
9708413,2,0,2,0.0,8.211974124807393e-20,1997-08-20
9708316,1,0,1,0.0,8.211974124807393e-20,1997-08-12
9909327,1,0,1,0.0,8.211974124807393e-20,1999-09-11
9903214,1,0,1,0.0,8.211974124807393e-20,1999-03-01
6104,1,0,1,0.0,8.211974124807393e-20,2000-06-11
9909386,1,0,1,0.0,8.211974124807393e-20,1999-09-15
9511421,1,0,1,0.0,8.211974124807393e-20,1995-11-27
9702290,1,0,1,0.0,8.211974124807393e-20,1997-02-07
4264,1,0,1,0.0,8.211974124807393e-20,2000-04-28
1280,1,0,1,0.0,8.211974124807393e-20,2000-01-27
112188,1,0,1,0.0,8.211974124807393e-20,2001-12-13
11244,1,0,1,0.0,8.211974124807393e-20,2000-11-20
9710551,1,0,1,0.0,8.211974124807393e-20,1997-10-31
102182,1,0,1,0.0,8.211974124807393e-20,2001-02-14
103058,1,0,1,0.0,8.211974124807393e-20,2001-03-06
107290,1,0,1,0.0,8.211974124807393e-20,2001-07-27
9307,1,0,1,0.0,8.211974124807393e-20,2000-09-27
201229,1,0,1,0.0,8.211974124807393e-20,2002-01-24
203092,1,0,1,0.0,8.211974124807393e-20,2002-03-08
8177,1,0,1,0.0,8.211974124807393e-20,2000-08-17
9805305,1,0,1,0.0,8.211974124807393e-20,1998-05-13
9711340,1,0,1,0.0,8.211974124807393e-20,1997-11-15
103261,1,0,1,0.0,8.211974124807393e-20,2001-03-23
3188,1,0,1,0.0,8.211974124807393e-20,2000-03-20
5149,1,0,1,0.0,8.211974124807393e-20,2000-05-16
9908414,1,0,1,0.0,8.211974124807393e-20,1999-08-19
9358,1,0,1,0.0,8.211974124807393e-20,2000-09-29
107106,2,0,2,0.0,8.211974124807393e-20,2001-07-10
6154,1,1,0,0.0,1.9069025115215267e-15,2000-06-14
7099,1,1,0,0.0,1.9069025115215267e-15,2000-07-11
7294,1,1,0,0.0,1.9069025115215267e-15,2000-07-26
7362,1,1,0,0.0,1.9069025115215267e-15,2000-07-31
11002,1,1,0,0.0,1.9069025115215267e-15,2000-11-01
102227,1,1,0,0.0,1.9069025115215267e-15,2001-02-18
102247,1,1,0,0.0,1.9069025115215267e-15,2001-02-20
103123,1,1,0,0.0,1.9069025115215267e-15,2001-03-12
106049,1,1,0,0.0,1.9069025115215267e-15,2001-06-05
106221,2,2,0,0.0,1.9104336603951936e-15,2001-06-20
9401214,1,1,0,0.0,1.9069025115215267e-15,1994-01-06
9510410,1,1,0,0.0,1.9069025115215267e-15,1995-10-25
9605317,1,1,0,0.0,1.9069025115215267e-15,1996-05-15
9907472,1,1,0,0.0,1.9069025115215267e-15,1999-07-23
108236,1,0,1,0.0,8.211974124807393e-20,2001-08-29
9902401,1,0,1,0.0,8.211974124807393e-20,1999-02-19
9902307,1,0,1,0.0,8.211974124807393e-20,1999-02-10
109139,1,0,1,0.0,8.211974124807393e-20,2001-09-17
107275,1,0,1,0.0,8.211974124807393e-20,2001-07-26
9912263,1,0,1,0.0,8.211974124807393e-20,1999-12-07
1143,1,0,1,0.0,8.211974124807393e-20,2000-01-15
203036,1,0,1,0.0,8.211974124807393e-20,2002-03-05
109073,1,0,1,0.0,8.211974124807393e-20,2001-09-10
9904313,1,0,1,0.0,8.211974124807393e-20,1999-04-13
102167,1,0,1,0.0,8.211974124807393e-20,2001-02-14
12364,1,0,1,0.0,8.211974124807393e-20,2000-12-28
9808497,29,3,26,7.581607254081821e-06,1.0675566362249613e-17,1998-08-31
9303233,1,1,0,0.0,2.2607564765594756e-16,1993-03-09
9311319,1,1,0,0.0,2.2607564765594756e-16,1993-11-19
9405394,1,1,0,0.0,2.2607564765594756e-16,1994-05-27
9405418,1,1,0,0.0,2.2607564765594756e-16,1994-05-30
9504215,1,1,0,0.0,2.2607564765594756e-16,1995-04-04
9505211,1,1,0,0.0,2.2607564765594756e-16,1995-05-02
9507240,1,1,0,0.0,2.2607564765594756e-16,1995-07-06
9507413,1,1,0,0.0,2.2607564765594756e-16,1995-07-25
9511407,1,1,0,0.0,2.2607564765594756e-16,1995-11-24
9511414,1,1,0,0.0,2.2607564765594756e-16,1995-11-25
9601347,1,1,0,0.0,2.2607564765594756e-16,1996-01-26
9602417,1,1,0,0.0,2.2607564765594756e-16,1996-02-28
9604333,1,1,0,0.0,2.2607564765594756e-16,1996-04-16
9606310,1,1,0,0.0,2.2607564765594756e-16,1996-06-12
9607455,1,1,0,0.0,2.2607564765594756e-16,1996-07-28
9608280,1,1,0,0.0,2.2607564765594756e-16,1996-08-09
9609447,1,1,0,0.0,2.2607564765594756e-16,1996-09-24
9611357,1,1,0,0.0,2.2607564765594756e-16,1996-11-18
9704299,1,1,0,0.0,2.2607564765594756e-16,1997-04-11
9709211,1,1,0,0.0,2.2607564765594756e-16,1997-09-01
9711318,1,1,0,0.0,2.2607564765594756e-16,1997-11-13
9801265,1,1,0,0.0,2.2607564765594756e-16,1998-01-12
9802367,1,1,0,0.0,2.2607564765594756e-16,1998-02-19
9805390,2,2,0,0.0,2.296067965296147e-16,1998-05-20
9807545,1,1,0,0.0,2.2607564765594756e-16,1998-07-30
9808393,1,1,0,0.0,2.2607564765594756e-16,1998-08-24
9504269,1,0,1,0.0,8.211974124807393e-20,1995-04-10
9311366,1,1,0,0.0,2.2607564765594756e-16,1993-11-26
9406224,1,1,0,0.0,2.2607564765594756e-16,1994-06-03
9407251,1,1,0,0.0,2.2607564765594756e-16,1994-07-07
9407404,1,1,0,0.0,2.2607564765594756e-16,1994-07-29
9411233,1,1,0,0.0,2.2607564765594756e-16,1994-11-07
9506393,1,1,0,0.0,2.2607564765594756e-16,1995-06-22
9606383,1,1,0,0.0,2.2607564765594756e-16,1996-06-19
9607383,1,1,0,0.0,2.2607564765594756e-16,1996-07-21
9612261,1,1,0,0.0,2.2607564765594756e-16,1996-12-05
9702431,1,1,0,0.0,2.2607564765594756e-16,1997-02-27
9703442,1,1,0,0.0,2.2607564765594756e-16,1997-03-27
9707497,1,1,0,0.0,2.2607564765594756e-16,1997-07-28
9712234,1,1,0,0.0,2.2607564765594756e-16,1997-12-02
9801353,1,1,0,0.0,2.2607564765594756e-16,1998-01-20
9805275,1,1,0,0.0,2.2607564765594756e-16,1998-05-10
9806429,1,1,0,0.0,2.2607564765594756e-16,1998-06-21
9808275,1,1,0,0.0,2.2607564765594756e-16,1998-08-10
9810374,1,1,0,0.0,2.2607564765594756e-16,1998-10-15
9811386,1,1,0,0.0,2.2607564765594756e-16,1998-11-18
9902347,1,0,1,0.0,8.211974124807393e-20,1999-02-15
6255,1,0,1,0.0,8.211974124807393e-20,2000-06-21
9705385,12,1,11,2.527202418027274e-06,3.613268614915252e-18,1997-05-21
108150,1,0,1,0.0,8.211974124807393e-20,2001-08-18
106059,1,0,1,0.0,8.211974124807393e-20,2001-06-05
9604334,1,0,1,0.0,8.211974124807393e-20,1996-04-16
105077,2,0,2,0.0,8.211974124807393e-20,2001-05-09
1086,2,2,0,0.0,2.2070501657832354e-15,2000-01-11
6182,1,1,0,0.0,1.0417710374730663e-15,2000-06-15
8270,1,1,0,0.0,1.0417710374730663e-15,2000-08-25
10017,2,2,0,0.0,2.2070501657832354e-15,2000-10-03
10338,2,2,0,0.0,1.0453021863467337e-15,2000-10-31
11363,1,1,0,0.0,1.0417710374730663e-15,2000-11-29
9305266,1,1,0,0.0,1.0417710374730663e-15,1993-05-13
9401258,2,2,0,0.0,1.193610439040755e-15,1994-01-14
9504314,1,1,0,0.0,1.0417710374730663e-15,1995-04-17
9710451,1,1,0,0.0,1.0417710374730663e-15,1997-10-23
9903282,2,2,0,0.0,1.193610439040755e-15,1999-03-08
9903549,1,1,0,0.0,1.0417710374730663e-15,1999-03-31
9906224,1,1,0,0.0,1.0417710374730663e-15,1999-06-03
9911479,1,1,0,0.0,1.0417710374730663e-15,1999-11-25
9912407,1,1,0,0.0,1.0417710374730663e-15,1999-12-17
9903274,1,0,1,0.0,8.211974124807393e-20,1999-03-05
108063,2,0,2,0.0,8.211974124807393e-20,2001-08-06
101353,1,0,1,0.0,8.211974124807393e-20,2001-01-31
1317,1,0,1,0.0,8.211974124807393e-20,2000-01-31
9908343,1,0,1,0.0,8.211974124807393e-20,1999-08-12
9909373,1,0,1,0.0,8.211974124807393e-20,1999-09-14
3160,1,1,0,0.0,8.463818947266991e-14,2000-03-16
5270,1,1,0,0.0,8.463818947266991e-14,2000-05-26
6277,1,1,0,0.0,8.463818947266991e-14,2000-06-23
8231,1,1,0,0.0,8.463818947266991e-14,2000-08-22
11213,1,1,0,0.0,8.463818947266991e-14,2000-11-16
12046,1,1,0,0.0,8.463818947266991e-14,2000-12-05
12345,1,1,0,0.0,8.463818947266991e-14,2000-12-27
101077,1,1,0,0.0,8.463818947266991e-14,2001-01-09
105305,1,1,0,0.0,8.463818947266991e-14,2001-05-29
110283,1,1,0,0.0,8.463818947266991e-14,2001-10-22
112359,1,1,0,0.0,8.463818947266991e-14,2001-12-30
9301272,1,1,0,0.0,8.463818947266991e-14,1993-01-26
9301289,1,1,0,0.0,8.463818947266991e-14,1993-01-28
9309202,1,1,0,0.0,8.463818947266991e-14,1993-09-01
9311257,1,1,0,0.0,8.463818947266991e-14,1993-11-10
9402224,1,1,0,0.0,8.463818947266991e-14,1994-02-03
9403398,1,1,0,0.0,8.463818947266991e-14,1994-03-30
9408224,1,1,0,0.0,8.463818947266991e-14,1994-08-03
9409224,1,1,0,0.0,8.463818947266991e-14,1994-09-05
9409225,1,1,0,0.0,8.463818947266991e-14,1994-09-05
9409310,1,1,0,0.0,8.463818947266991e-14,1994-09-14
9503228,1,1,0,0.0,8.463818947266991e-14,1995-03-03
9603240,1,1,0,0.0,8.463818947266991e-14,1996-03-06
9607313,1,1,0,0.0,8.463818947266991e-14,1996-07-15
9708446,1,1,0,0.0,8.463818947266991e-14,1997-08-25
9808419,1,1,0,0.0,8.463818947266991e-14,1998-08-26
9811379,1,1,0,0.0,8.463818947266991e-14,1998-11-18
9812525,1,1,0,0.0,8.463818947266991e-14,1998-12-30
9901206,1,1,0,0.0,8.463818947266991e-14,1999-01-02
9906253,1,1,0,0.0,8.463818947266991e-14,1999-06-04
9906297,1,1,0,0.0,8.463818947266991e-14,1999-06-08
9906446,1,1,0,0.0,8.463818947266991e-14,1999-06-22
9906469,1,1,0,0.0,8.463818947266991e-14,1999-06-23
9907203,1,1,0,0.0,8.463818947266991e-14,1999-07-01
9908435,1,1,0,0.0,8.463818947266991e-14,1999-08-23
9910213,1,1,0,0.0,8.463818947266991e-14,1999-10-03
9912231,1,1,0,0.0,8.463818947266991e-14,1999-12-03
203045,1,0,1,0.0,8.211974124807393e-20,2002-03-05
9908488,1,0,1,0.0,8.211974124807393e-20,1999-08-27
3139,1,0,1,0.0,8.211974124807393e-20,2000-03-15
9909415,1,0,1,0.0,8.211974124807393e-20,1999-09-17
4055,1,0,1,0.0,8.211974124807393e-20,2000-04-06
9605201,1,0,1,0.0,8.211974124807393e-20,1996-05-02
102173,1,0,1,0.0,8.211974124807393e-20,2001-02-14
201219,1,0,1,0.0,8.211974124807393e-20,2002-01-23
202012,1,0,1,0.0,8.211974124807393e-20,2002-02-03
10061,1,0,1,0.0,8.211974124807393e-20,2000-10-06
7309,18,6,12,6.998406696075527e-06,2.1269012983251138e-17,2000-07-26
2222,1,1,0,0.0,4.485380266969801e-16,2000-02-21
3301,1,1,0,0.0,4.485380266969801e-16,2000-03-30
7081,1,1,0,0.0,4.485380266969801e-16,2000-07-10
7231,1,1,0,0.0,4.485380266969801e-16,2000-07-20
9605409,1,1,0,0.0,4.485380266969801e-16,1996-05-27
9609250,1,1,0,0.0,4.485380266969801e-16,1996-09-04
9705224,1,1,0,0.0,4.485380266969801e-16,1997-05-04
9806541,1,1,0,0.0,4.485380266969801e-16,1998-06-30
9903388,1,1,0,0.0,4.485380266969801e-16,1999-03-17
9909471,1,1,0,0.0,4.485380266969801e-16,1999-09-22
9910203,1,1,0,0.0,4.485380266969801e-16,1999-10-01
108224,1,0,1,0.0,8.211974124807393e-20,2001-08-27
9704263,2,0,2,0.0,8.211974124807393e-20,1997-04-08
9706481,1,0,1,0.0,8.211974124807393e-20,1997-06-24
3030,1,0,1,0.0,8.211974124807393e-20,2000-03-03
7126,1,0,1,0.0,8.211974124807393e-20,2000-07-12
9908511,1,0,1,0.0,8.211974124807393e-20,1999-08-30
9602361,1,0,1,0.0,8.211974124807393e-20,1996-02-21
9504223,1,0,1,0.0,8.211974124807393e-20,1995-04-05
112134,1,0,1,0.0,8.211974124807393e-20,2001-12-10
9908262,1,0,1,0.0,8.211974124807393e-20,1999-08-05
201227,2,1,1,5.6376053940608414e-06,3.613268614915252e-18,2002-01-23
11253,25,2,23,1.6621215903179377e-05,8.12985438355932e-17,2000-11-20
3035,1,1,0,0.0,3.613268614915252e-18,2000-03-05
107081,1,1,0,0.0,3.613268614915252e-18,2001-07-09
9312319,1,1,0,0.0,3.613268614915252e-18,1993-12-20
9503415,1,1,0,0.0,3.613268614915252e-18,1995-03-22
9511310,1,1,0,0.0,3.613268614915252e-18,1995-11-13
9606399,3,3,0,0.0,3.0729207175029256e-16,1996-06-21
9607379,1,1,0,0.0,3.613268614915252e-18,1996-07-19
9705398,1,1,0,0.0,3.613268614915252e-18,1997-05-22
9708455,1,1,0,0.0,3.613268614915252e-18,1997-08-25
9711328,1,1,0,0.0,3.613268614915252e-18,1997-11-13
9806259,1,1,0,0.0,3.613268614915252e-18,1998-06-04
9809552,1,1,0,0.0,3.613268614915252e-18,1998-09-26
9811492,1,1,0,0.0,3.613268614915252e-18,1998-11-27
9812201,1,1,0,0.0,3.613268614915252e-18,1998-12-01
112088,1,0,1,0.0,8.211974124807393e-20,2001-12-05
107332,16,2,14,2.7216026040293718e-06,7.144417488582434e-18,2001-07-31
9901282,1,0,1,0.0,8.211974124807393e-20,1999-01-12
9210253,2,2,0,0.0,1.0834993252857087e-06,1992-10-20
9303281,2,2,0,0.0,1.0834993252857087e-06,1993-03-18
9308214,1,1,0,0.0,8.193086584320325e-16,1993-08-03
9309257,1,1,0,0.0,8.193086584320325e-16,1993-09-13
9310253,1,1,0,0.0,8.193086584320325e-16,1993-10-08
9311350,1,1,0,0.0,8.193086584320325e-16,1993-11-23
9402221,1,1,0,0.0,8.193086584320325e-16,1994-02-03
9502335,1,1,0,0.0,8.193086584320325e-16,1995-02-17
9504310,1,1,0,0.0,8.193086584320325e-16,1995-04-16
9505267,1,1,0,0.0,8.193086584320325e-16,1995-05-09
9604227,1,1,0,0.0,8.193086584320325e-16,1996-04-02
9606468,1,1,0,0.0,8.193086584320325e-16,1996-06-27
9606483,1,1,0,0.0,8.193086584320325e-16,1996-06-29
9607411,1,1,0,0.0,8.193086584320325e-16,1996-07-23
9610353,1,1,0,0.0,8.193086584320325e-16,1996-10-14
9704345,1,1,0,0.0,8.193086584320325e-16,1997-04-17
9705474,1,1,0,0.0,8.193086584320325e-16,1997-05-30
9708425,1,1,0,0.0,8.193086584320325e-16,1997-08-21
9710397,1,1,0,0.0,8.193086584320325e-16,1997-10-18
9711395,1,1,0,0.0,8.193086584320325e-16,1997-11-19
9711396,1,1,0,0.0,8.193086584320325e-16,1997-11-19
9803386,1,1,0,0.0,8.193086584320325e-16,1998-03-18
9804233,1,1,0,0.0,8.193086584320325e-16,1998-04-06
9804290,1,1,0,0.0,8.193086584320325e-16,1998-04-15
9804403,1,1,0,0.0,8.193086584320325e-16,1998-04-27
9806219,1,1,0,0.0,8.193086584320325e-16,1998-06-01
9807243,1,1,0,0.0,8.193086584320325e-16,1998-07-03
9807362,1,1,0,0.0,8.193086584320325e-16,1998-07-13
9808444,1,1,0,0.0,8.193086584320325e-16,1998-08-27
9809289,1,1,0,0.0,8.193086584320325e-16,1998-09-07
9810281,1,1,0,0.0,8.193086584320325e-16,1998-10-08
9810509,1,1,0,0.0,8.193086584320325e-16,1998-10-28
9810514,1,1,0,0.0,8.193086584320325e-16,1998-10-28
9811347,1,1,0,0.0,8.193086584320325e-16,1998-11-16
9811387,1,1,0,0.0,8.193086584320325e-16,1998-11-18
9811473,1,1,0,0.0,8.193086584320325e-16,1998-11-25
9812287,1,1,0,0.0,8.193086584320325e-16,1998-12-08
9812445,1,1,0,0.0,8.193086584320325e-16,1998-12-19
9609324,1,0,1,0.0,8.211974124807393e-20,1996-09-11
101314,1,0,1,0.0,8.211974124807393e-20,2001-01-29
112142,27,2,25,4.86000465005245e-06,7.144417488582434e-18,2001-12-11
9701316,1,0,1,0.0,8.211974124807393e-20,1997-01-18
1029,3,0,3,0.0,8.211974124807393e-20,2000-01-04
9904456,1,0,1,0.0,8.211974124807393e-20,1999-04-26
9912369,3,0,3,0.0,8.211974124807393e-20,1999-12-15
6275,1,0,1,0.0,8.211974124807393e-20,2000-06-23
9808361,1,0,1,0.0,8.211974124807393e-20,1998-08-19
9810283,1,0,1,0.0,8.211974124807393e-20,1998-10-08
6035,1,0,1,0.0,8.211974124807393e-20,2000-06-03
12353,1,0,1,0.0,8.211974124807393e-20,2000-12-28
9602341,1,0,1,0.0,8.211974124807393e-20,1996-02-19
103115,1,0,1,0.0,8.211974124807393e-20,2001-03-12
106291,1,1,0,0.0,2.2607564765594756e-16,2001-06-26
201225,2,2,0,0.0,2.296067965296147e-16,2002-01-23
201231,2,2,0,0.0,2.296067965296147e-16,2002-01-24
9805219,1,1,0,0.0,2.2607564765594756e-16,1998-05-04
9612349,1,0,1,0.0,8.211974124807393e-20,1996-12-12
9710307,1,0,1,0.0,8.211974124807393e-20,1997-10-09
9705309,1,0,1,0.0,8.211974124807393e-20,1997-05-14
7339,1,0,1,0.0,8.211974124807393e-20,2000-07-28
9209271,1,1,0,0.0,1.387823627092449e-15,1992-09-23
9212266,1,1,0,0.0,1.387823627092449e-15,1992-12-15
9305304,1,1,0,0.0,1.387823627092449e-15,1993-05-24
9407394,1,1,0,0.0,1.387823627092449e-15,1994-07-28
9504235,1,1,0,0.0,1.387823627092449e-15,1995-04-05
9508211,1,1,0,0.0,1.387823627092449e-15,1995-08-01
9603261,1,1,0,0.0,1.387823627092449e-15,1996-03-10
9603414,1,1,0,0.0,1.387823627092449e-15,1996-03-26
9610518,1,1,0,0.0,1.387823627092449e-15,1996-10-28
9703277,1,1,0,0.0,1.387823627092449e-15,1997-03-09
9705252,1,1,0,0.0,1.387823627092449e-15,1997-05-06
9712417,1,1,0,0.0,1.387823627092449e-15,1997-12-17
9903305,1,1,0,0.0,1.387823627092449e-15,1999-03-10
110275,1,0,1,0.0,8.211974124807393e-20,2001-10-22
2051,1,0,1,0.0,8.211974124807393e-20,2000-02-04
107247,1,1,0,0.0,3.613268614915252e-18,2001-07-24
109081,1,1,0,0.0,3.613268614915252e-18,2001-09-10
111267,1,1,0,0.0,3.613268614915252e-18,2001-11-21
9308274,1,1,0,0.0,3.613268614915252e-18,1993-08-13
9501369,1,1,0,0.0,3.613268614915252e-18,1995-01-25
9602272,1,1,0,0.0,3.613268614915252e-18,1996-02-12
9604388,1,1,0,0.0,3.613268614915252e-18,1996-04-23
9612319,1,1,0,0.0,3.613268614915252e-18,1996-12-10
9704333,1,1,0,0.0,3.613268614915252e-18,1997-04-16
9706534,1,1,0,0.0,3.613268614915252e-18,1997-06-28
9803342,1,1,0,0.0,3.613268614915252e-18,1998-03-13
9806345,1,1,0,0.0,3.613268614915252e-18,1998-06-11
9810224,1,1,0,0.0,3.613268614915252e-18,1998-10-02
9812348,1,1,0,0.0,3.613268614915252e-18,1998-12-13
9905310,1,1,0,0.0,3.613268614915252e-18,1999-05-11
12321,1,0,1,0.0,8.211974124807393e-20,2000-12-23
9610543,1,0,1,0.0,8.211974124807393e-20,1996-10-30
9909494,1,0,1,0.0,8.211974124807393e-20,1999-09-23
9605238,1,0,1,0.0,8.211974124807393e-20,1996-05-07
2007,1,0,1,0.0,8.211974124807393e-20,2000-02-01
202179,1,0,1,0.0,8.211974124807393e-20,2002-02-19
6347,1,0,1,0.0,8.211974124807393e-20,2000-06-30
102198,1,0,1,0.0,8.211974124807393e-20,2001-02-15
105101,1,0,1,0.0,8.211974124807393e-20,2001-05-11
9901425,1,0,1,0.0,8.211974124807393e-20,1999-01-26
9702279,1,0,1,0.0,8.211974124807393e-20,1997-02-07
104069,1,0,1,0.0,8.211974124807393e-20,2001-04-06
9501230,1,1,0,0.0,2.2607564765594756e-16,1995-01-06
9503464,1,1,0,0.0,2.2607564765594756e-16,1995-03-29
9505203,1,1,0,0.0,2.2607564765594756e-16,1995-05-01
9511386,1,1,0,0.0,2.2607564765594756e-16,1995-11-21
9611391,1,1,0,0.0,2.2607564765594756e-16,1996-11-21
9704258,1,1,0,0.0,2.2607564765594756e-16,1997-04-08
9712471,1,1,0,0.0,2.2607564765594756e-16,1997-12-21
9801268,1,1,0,0.0,2.2607564765594756e-16,1998-01-12
9803241,1,1,0,0.0,2.2607564765594756e-16,1998-03-04
9803445,2,2,0,0.0,3.7791504922363627e-16,1998-03-25
9806467,1,1,0,0.0,2.2607564765594756e-16,1998-06-24
9806484,1,1,0,0.0,2.2607564765594756e-16,1998-06-25
9910530,1,0,1,0.0,8.211974124807393e-20,1999-10-28
8120,1,0,1,0.0,8.211974124807393e-20,2000-08-12
9910499,1,0,1,0.0,8.211974124807393e-20,1999-10-27
112063,1,0,1,0.0,8.211974124807393e-20,2000-02-17
112063,1,0,1,0.0,8.211974124807393e-20,2001-12-04
9505366,1,0,1,0.0,8.211974124807393e-20,1995-05-23
112321,1,0,1,0.0,8.211974124807393e-20,2001-12-24
111014,1,0,1,0.0,8.211974124807393e-20,2000-01-07
111014,1,0,1,0.0,8.211974124807393e-20,2001-11-01
9805278,1,0,1,0.0,8.211974124807393e-20,1998-05-11
111155,1,0,1,0.0,8.211974124807393e-20,2001-11-13
111003,1,0,1,0.0,8.211974124807393e-20,2001-10-31
4103,1,0,1,0.0,8.211974124807393e-20,2000-04-11
9203201,2,2,0,0.0,5.262233019176575e-16,1992-02-24
9203203,2,2,0,0.0,5.262233019176575e-16,1992-03-03
9204216,1,1,0,0.0,5.226921530439902e-16,1992-04-10
9206227,1,1,0,0.0,5.226921530439902e-16,1992-06-17
9206266,2,2,0,0.0,5.262233019176575e-16,1992-06-30
9209245,2,2,0,0.0,5.262233019176575e-16,1992-09-16
9209252,1,1,0,0.0,5.226921530439902e-16,1992-09-18
9210228,1,1,0,0.0,5.226921530439902e-16,1992-10-12
9212235,2,2,0,0.0,5.262233019176575e-16,1992-12-07
9302210,3,3,0,0.0,6.249788603477667e-14,1993-02-03
9303317,2,2,0,0.0,5.262233019176575e-16,1993-03-30
9304256,1,1,0,0.0,5.226921530439902e-16,1993-04-15
9312296,2,2,0,0.0,5.262233019176575e-16,1993-12-16
9408253,1,1,0,0.0,5.226921530439902e-16,1994-08-09
9508202,1,1,0,0.0,5.226921530439902e-16,1995-08-01
9603420,1,1,0,0.0,5.226921530439902e-16,1996-03-26
9604320,1,1,0,0.0,5.226921530439902e-16,1996-04-15
9605387,1,1,0,0.0,5.226921530439902e-16,1996-05-23
9609481,1,1,0,0.0,5.226921530439902e-16,1996-09-25
9612364,1,1,0,0.0,5.226921530439902e-16,1996-12-15
9703212,1,1,0,0.0,5.226921530439902e-16,1997-03-02
9710401,1,1,0,0.0,5.226921530439902e-16,1997-10-20
9801272,1,1,0,0.0,5.226921530439902e-16,1998-01-12
9804255,1,1,0,0.0,5.226921530439902e-16,1998-04-08
9805264,1,1,0,0.0,5.226921530439902e-16,1998-05-08
9810217,1,1,0,0.0,5.226921530439902e-16,1998-10-01
9810265,1,1,0,0.0,5.226921530439902e-16,1998-10-06
9810313,1,1,0,0.0,5.226921530439902e-16,1998-10-09
9707403,1,0,1,0.0,8.211974124807393e-20,1997-07-20
110383,1,0,1,0.0,8.211974124807393e-20,2001-10-30
9810427,1,0,1,0.0,8.211974124807393e-20,1998-10-21
9906444,1,0,1,0.0,8.211974124807393e-20,1999-06-23
107132,1,0,1,0.0,8.211974124807393e-20,2001-07-12
201234,24,2,22,4.276804092046155e-06,7.144417488582434e-18,2002-01-24
7292,1,1,0,0.0,1.519215213089368e-16,2000-07-26
12062,1,1,0,0.0,1.519215213089368e-16,2000-12-06
106120,1,1,0,0.0,1.519215213089368e-16,2001-06-12
112050,1,1,0,0.0,1.519215213089368e-16,2001-12-04
112199,1,1,0,0.0,1.519215213089368e-16,2001-12-14
112259,1,1,0,0.0,1.519215213089368e-16,2001-12-19
9411365,1,1,0,0.0,1.519215213089368e-16,1994-11-22
9505329,1,1,0,0.0,1.519215213089368e-16,1995-05-17
9511315,1,1,0,0.0,1.519215213089368e-16,1995-11-14
9602374,2,2,0,0.0,1.5545267018260395e-16,1996-02-22
9703280,1,1,0,0.0,1.519215213089368e-16,1997-03-10
9707223,2,2,0,0.0,1.5545267018260395e-16,1997-07-02
9708349,1,1,0,0.0,1.519215213089368e-16,1997-08-14
9709376,1,1,0,0.0,1.519215213089368e-16,1997-09-17
9906254,1,1,0,0.0,1.519215213089368e-16,1999-06-04
9909246,1,0,1,0.0,8.211974124807393e-20,1999-09-03
112070,1,0,1,0.0,8.211974124807393e-20,2001-12-05
111040,1,0,1,0.0,8.211974124807393e-20,2000-01-21
111040,1,0,1,0.0,8.211974124807393e-20,2001-11-05
10294,2,1,1,0.0,2.889331531910347e-06,2000-10-25
6205,1,1,0,0.0,2.889331531910347e-06,2000-06-17
7109,1,1,0,0.0,2.889331531910347e-06,2000-07-12
9408276,2,2,0,0.0,2.8893315319138784e-06,1994-08-11
9410360,2,2,0,0.0,2.8893315319138784e-06,1994-10-24
9507380,2,2,0,0.0,2.8893315319138784e-06,1995-07-21
9510408,2,2,0,0.0,2.8893315319138784e-06,1995-10-25
9708219,1,1,0,0.0,2.889331531910347e-06,1997-08-02
9708257,1,1,0,0.0,2.889331531910347e-06,1997-08-06
9708426,2,2,0,0.0,2.8893315319138784e-06,1997-08-21
9811367,1,1,0,0.0,2.889331531910347e-06,1998-11-17
9902327,2,2,0,0.0,2.8893315319138784e-06,1999-02-11
9906340,1,1,0,0.0,2.889331531910347e-06,1999-06-11
9902211,1,0,1,0.0,8.211974124807393e-20,1999-02-01
2023,1,0,1,0.0,8.211974124807393e-20,2000-02-02
3258,1,1,0,0.0,1.519215213089368e-16,2000-03-27
4226,1,1,0,0.0,1.519215213089368e-16,2000-04-25
5297,1,1,0,0.0,1.519215213089368e-16,2000-05-30
7112,1,1,0,0.0,1.519215213089368e-16,2000-07-12
11049,1,1,0,0.0,1.519215213089368e-16,2000-11-03
103063,1,1,0,0.0,1.519215213089368e-16,2001-03-06
9502285,1,1,0,0.0,1.519215213089368e-16,1995-02-13
9507319,1,1,0,0.0,1.519215213089368e-16,1995-07-17
9511397,1,1,0,0.0,1.519215213089368e-16,1995-11-23
9512404,1,1,0,0.0,1.519215213089368e-16,1995-12-22
9602366,1,1,0,0.0,1.519215213089368e-16,1996-02-22
9707291,1,1,0,0.0,1.519215213089368e-16,1997-07-09
9910438,1,1,0,0.0,1.519215213089368e-16,1999-10-21
108245,1,0,1,0.0,8.211974124807393e-20,2001-08-29
203028,1,0,1,0.0,8.211974124807393e-20,2002-03-04
201119,1,0,1,0.0,8.211974124807393e-20,2002-01-14
106329,1,0,1,0.0,8.211974124807393e-20,2001-06-28
3009,1,0,1,0.0,8.211974124807393e-20,2000-03-01
112243,1,0,1,0.0,8.211974124807393e-20,2000-02-11
112243,1,0,1,0.0,8.211974124807393e-20,2001-12-18
9912478,1,0,1,0.0,8.211974124807393e-20,1999-12-22
7330,1,0,1,0.0,8.211974124807393e-20,2000-07-28
9710210,1,0,1,0.0,8.211974124807393e-20,1997-10-01
9903219,1,0,1,0.0,8.211974124807393e-20,1999-03-01
105233,1,0,1,0.0,8.211974124807393e-20,2001-05-22
1005,1,1,0,0.0,1.165361248051417e-15,2000-01-03
10244,1,1,0,0.0,1.165361248051417e-15,2000-10-20
9504234,1,1,0,0.0,1.165361248051417e-15,1995-04-05
9604406,1,1,0,0.0,1.165361248051417e-15,1996-04-25
9704457,1,1,0,0.0,1.165361248051417e-15,1997-04-30
9802441,1,1,0,0.0,1.165361248051417e-15,1998-02-26
9804451,1,1,0,0.0,1.165361248051417e-15,1998-04-29
9806366,1,1,0,0.0,1.165361248051417e-15,1998-06-15
9811300,1,1,0,0.0,1.165361248051417e-15,1998-11-11
9811489,1,1,0,0.0,1.165361248051417e-15,1998-11-27
9903238,1,1,0,0.0,1.165361248051417e-15,1999-03-03
9903370,1,1,0,0.0,1.165361248051417e-15,1999-03-16
9904282,1,1,0,0.0,1.165361248051417e-15,1999-04-08
9906233,1,1,0,0.0,1.165361248051417e-15,1999-06-03
9907505,1,1,0,0.0,1.165361248051417e-15,1999-07-27
9910500,1,1,0,0.0,1.165361248051417e-15,1999-10-27
107239,1,0,1,0.0,8.211974124807393e-20,2001-07-23
110349,1,0,1,0.0,8.211974124807393e-20,2001-10-26
109118,1,0,1,0.0,8.211974124807393e-20,2001-09-13
2063,1,1,0,0.0,6.197174485260025e-14,2000-02-06
2064,1,1,0,0.0,6.197174485260025e-14,2000-02-07
5261,1,1,0,0.0,6.197174485260025e-14,2000-05-25
6119,1,1,0,0.0,6.197174485260025e-14,2000-06-12
8019,1,1,0,0.0,6.197174485260025e-14,2000-08-02
10178,1,1,0,0.0,6.197174485260025e-14,2000-10-17
11055,1,1,0,0.0,6.197174485260025e-14,2000-11-03
11251,1,1,0,0.0,6.197174485260025e-14,2000-11-20
12075,1,1,0,0.0,6.197174485260025e-14,2000-12-06
106207,1,1,0,0.0,6.197174485260025e-14,2001-06-18
106264,1,1,0,0.0,6.197174485260025e-14,2001-06-25
107150,1,1,0,0.0,6.197174485260025e-14,2001-07-13
107153,1,1,0,0.0,6.197174485260025e-14,2001-07-13
107186,1,1,0,0.0,6.197174485260025e-14,2001-07-17
108177,1,1,0,0.0,6.197174485260025e-14,2001-08-22
109030,1,1,0,0.0,6.197174485260025e-14,2001-09-04
110031,1,1,0,0.0,6.197174485260025e-14,2001-10-02
111030,1,1,0,0.0,6.197174485260025e-14,2001-11-02
111418,1,1,0,0.0,6.197174485260025e-14,2001-11-29
9605273,1,1,0,0.0,6.197174485260025e-14,1996-05-10
9811428,1,1,0,0.0,6.197174485260025e-14,1998-11-21
9811448,1,1,0,0.0,6.197174485260025e-14,1998-11-24
9903454,1,1,0,0.0,6.197174485260025e-14,1999-03-23
9904399,1,1,0,0.0,6.197174485260025e-14,1999-04-20
9910387,1,1,0,0.0,6.197174485260025e-14,1999-10-18
9912408,1,1,0,0.0,6.197174485260025e-14,1999-12-17
9910472,1,0,1,0.0,8.211974124807393e-20,1999-10-25
202279,1,0,1,0.0,8.211974124807393e-20,2002-02-28
9712343,1,0,1,0.0,8.211974124807393e-20,1997-12-11
9811432,1,0,1,0.0,8.211974124807393e-20,1998-11-21
201047,1,0,1,0.0,8.211974124807393e-20,2002-01-08
6267,1,0,1,0.0,8.211974124807393e-20,2000-06-23
6253,1,0,1,0.0,8.211974124807393e-20,2000-06-21
112018,1,0,1,0.0,8.211974124807393e-20,2000-02-07
112018,1,0,1,0.0,8.211974124807393e-20,2001-12-03
106138,1,0,1,0.0,8.211974124807393e-20,2001-06-13
1286,1,1,0,0.0,1.519215213089368e-16,2000-01-27
4223,1,1,0,0.0,1.519215213089368e-16,2000-04-25
6307,1,1,0,0.0,1.519215213089368e-16,2000-06-27
12177,1,1,0,0.0,1.519215213089368e-16,2000-12-14
108190,1,1,0,0.0,1.519215213089368e-16,2001-08-23
110063,1,1,0,0.0,1.519215213089368e-16,2001-10-04
112035,1,1,0,0.0,1.519215213089368e-16,2000-02-08
112035,1,1,0,0.0,1.519215213089368e-16,2001-12-03
9309234,1,1,0,0.0,1.519215213089368e-16,1993-09-07
9311332,1,1,0,0.0,1.519215213089368e-16,1993-11-22
9409380,2,2,0,0.0,1.5545267018260395e-16,1994-09-22
9501358,1,1,0,0.0,1.519215213089368e-16,1995-01-23
9504434,1,1,0,0.0,1.519215213089368e-16,1995-04-30
9706339,1,1,0,0.0,1.519215213089368e-16,1997-06-12
9707326,1,1,0,0.0,1.519215213089368e-16,1997-07-11
9710521,1,1,0,0.0,1.519215213089368e-16,1997-10-29
9805318,1,1,0,0.0,1.519215213089368e-16,1998-05-13
9806306,1,1,0,0.0,1.519215213089368e-16,1998-06-08
9807209,1,1,0,0.0,1.519215213089368e-16,1998-07-01
9811481,1,1,0,0.0,1.519215213089368e-16,1998-11-26
9902304,1,1,0,0.0,1.519215213089368e-16,1999-02-10
9904472,1,1,0,0.0,1.519215213089368e-16,1999-04-28
9906326,1,1,0,0.0,1.519215213089368e-16,1999-06-10
9910519,1,1,0,0.0,1.519215213089368e-16,1999-10-27
9911505,1,1,0,0.0,1.519215213089368e-16,1999-11-27
112238,1,0,1,0.0,8.211974124807393e-20,2001-12-18
201156,1,0,1,0.0,8.211974124807393e-20,2002-01-17
112025,1,0,1,0.0,8.211974124807393e-20,2000-02-21
112025,1,0,1,0.0,8.211974124807393e-20,2001-12-03
202162,1,0,1,0.0,8.211974124807393e-20,2002-02-16
112209,1,0,1,0.0,8.211974124807393e-20,2001-12-14
1285,1,0,1,0.0,8.211974124807393e-20,2000-01-27
7165,1,0,1,0.0,8.211974124807393e-20,2000-07-16
9501347,1,1,0,0.0,1.8058322074440267e-06,1995-01-20
9503204,1,1,0,0.0,1.8058322074440267e-06,1995-03-01
9506461,1,1,0,0.0,1.8058322074440267e-06,1995-06-29
9603247,1,1,0,0.0,1.8058322074440267e-06,1996-03-07
9606231,1,1,0,0.0,1.8058322074440267e-06,1996-06-04
9703410,1,1,0,0.0,1.8058322074440267e-06,1997-03-25
9709369,1,1,0,0.0,1.8058322074440267e-06,1997-09-17
9803369,1,1,0,0.0,1.8058322074440267e-06,1998-03-17
9806486,1,1,0,0.0,1.8058322074440267e-06,1998-06-25
9806489,1,1,0,0.0,1.8058322074440267e-06,1998-06-26
9808400,1,1,0,0.0,1.8058322074440267e-06,1998-08-24
9811237,1,1,0,0.0,1.8058322074440267e-06,1998-11-04
3257,16,2,14,2.7216026040293718e-06,7.144417488582434e-18,2000-03-27
105307,1,0,1,0.0,8.211974124807393e-20,2001-05-29
9125,2,0,2,0.0,8.211974124807393e-20,2000-09-11
201265,1,0,1,0.0,8.211974124807393e-20,2002-01-29
201146,1,0,1,0.0,8.211974124807393e-20,2002-01-16
12332,1,1,0,0.0,7.7767394961926e-17,2000-12-25
9210277,1,1,0,0.0,7.7767394961926e-17,1992-10-29
9510376,1,1,0,0.0,7.7767394961926e-17,1995-10-23
9601297,1,1,0,0.0,7.7767394961926e-17,1996-01-18
9602221,1,1,0,0.0,7.7767394961926e-17,1996-02-04
9702381,1,1,0,0.0,7.7767394961926e-17,1997-02-21
9702414,1,1,0,0.0,7.7767394961926e-17,1997-02-25
9706331,1,1,0,0.0,7.7767394961926e-17,1997-06-12
9707484,1,1,0,0.0,7.7767394961926e-17,1997-07-27
9711202,1,1,0,0.0,7.7767394961926e-17,1997-11-02
9810367,1,1,0,0.0,7.7767394961926e-17,1998-10-15
9905347,1,1,0,0.0,7.7767394961926e-17,1999-05-14
9910227,1,1,0,0.0,7.7767394961926e-17,1999-10-04
9912325,1,0,1,0.0,8.211974124807393e-20,1999-12-13
1122,1,1,0,0.0,1.519215213089368e-16,2000-01-13
2285,1,1,0,0.0,1.519215213089368e-16,2000-02-28
4050,1,1,0,0.0,1.519215213089368e-16,2000-04-06
5162,1,1,0,0.0,1.519215213089368e-16,2000-05-17
6128,1,1,0,0.0,1.519215213089368e-16,2000-06-13
8058,1,1,0,0.0,1.519215213089368e-16,2000-08-07
11134,1,1,0,0.0,1.519215213089368e-16,2000-11-09
106119,1,1,0,0.0,1.519215213089368e-16,2001-06-12
111233,1,1,0,0.0,1.519215213089368e-16,2000-01-13
111233,1,1,0,0.0,1.519215213089368e-16,2001-11-19
111348,1,1,0,0.0,1.519215213089368e-16,2001-11-27
9707423,1,1,0,0.0,1.519215213089368e-16,1997-07-22
9711514,1,1,0,0.0,1.519215213089368e-16,1997-11-28
9803380,1,1,0,0.0,1.519215213089368e-16,1998-03-18
9807278,1,1,0,0.0,1.519215213089368e-16,1998-07-07
9909509,1,1,0,0.0,1.519215213089368e-16,1999-09-25
7139,1,0,1,0.0,8.211974124807393e-20,2000-07-13
102205,1,0,1,0.0,8.211974124807393e-20,2001-02-16
9911429,1,0,1,0.0,8.211974124807393e-20,1999-11-21
105014,3,0,3,0.0,8.211974124807393e-20,2001-05-02
110279,1,0,1,0.0,8.211974124807393e-20,2001-10-22
7098,1,0,1,0.0,8.211974124807393e-20,2000-07-11
110157,1,0,1,0.0,8.211974124807393e-20,2001-10-11
5179,1,0,1,0.0,8.211974124807393e-20,2000-05-18
9708288,1,0,1,0.0,8.211974124807393e-20,1997-08-08
112301,1,0,1,0.0,8.211974124807393e-20,2001-12-21
8291,20,1,19,1.8468017670199307e-06,3.613268614915252e-18,2000-08-28
9212246,1,1,0,0.0,7.7767394961926e-17,1992-12-10
9302240,1,1,0,0.0,7.7767394961926e-17,1993-02-09
9411386,1,1,0,0.0,7.7767394961926e-17,1994-11-24
9505355,1,1,0,0.0,7.7767394961926e-17,1995-05-22
9512328,1,1,0,0.0,7.7767394961926e-17,1995-12-16
9609213,1,1,0,0.0,7.7767394961926e-17,1996-08-31
9701424,1,1,0,0.0,7.7767394961926e-17,1997-01-30
9703305,1,1,0,0.0,7.7767394961926e-17,1997-03-12
9703359,1,1,0,0.0,7.7767394961926e-17,1997-03-18
9708350,1,1,0,0.0,7.7767394961926e-17,1997-08-14
9709360,1,1,0,0.0,7.7767394961926e-17,1997-09-16
9802431,1,1,0,0.0,7.7767394961926e-17,1998-02-26
9809411,1,1,0,0.0,7.7767394961926e-17,1998-09-16
9812415,1,1,0,0.0,7.7767394961926e-17,1998-12-17
9812492,1,1,0,0.0,7.7767394961926e-17,1998-12-24
9905276,1,1,0,0.0,7.7767394961926e-17,1999-05-07
9905424,1,1,0,0.0,7.7767394961926e-17,1999-05-20
105040,1,0,1,0.0,8.211974124807393e-20,2001-05-04
9905422,1,0,1,0.0,8.211974124807393e-20,1999-05-20
105290,1,0,1,0.0,8.211974124807393e-20,2001-05-28
9405319,15,0,15,0.0,8.211974124807393e-20,1994-05-18
9206235,1,1,0,0.0,3.613268614915252e-18,1992-06-19
9212248,2,2,0,0.0,7.144417488582434e-18,1992-12-10
9212288,1,1,0,0.0,3.613268614915252e-18,1992-12-20
9301285,1,1,0,0.0,3.613268614915252e-18,1993-01-27
9302314,1,1,0,0.0,3.613268614915252e-18,1993-02-26
9305274,1,1,0,0.0,3.613268614915252e-18,1993-05-17
9305345,1,1,0,0.0,3.613268614915252e-18,1993-05-28
9306296,1,1,0,0.0,3.613268614915252e-18,1993-06-21
12102,1,1,0,0.0,1.0834993244664822e-06,2000-12-09
201053,1,1,0,0.0,1.0834993244664822e-06,2002-01-08
201166,1,1,0,0.0,1.0834993244664822e-06,2002-01-18
202250,1,1,0,0.0,1.0834993244664822e-06,2002-02-26
9309235,1,1,0,0.0,1.0834993244664822e-06,1993-09-07
9312349,1,1,0,0.0,1.0834993244664822e-06,1993-12-28
9404356,1,1,0,0.0,1.0834993244664822e-06,1994-04-29
9406383,1,1,0,0.0,1.0834993244664822e-06,1994-06-23
9509398,1,1,0,0.0,1.0834993244664822e-06,1995-09-26
9805296,1,1,0,0.0,1.0834993244664822e-06,1998-05-12
106205,1,0,1,0.0,8.211974124807393e-20,2001-06-18
9310350,1,1,0,0.0,1.519215213089368e-16,1993-10-26
9601201,1,1,0,0.0,1.519215213089368e-16,1996-01-02
9604437,1,1,0,0.0,1.519215213089368e-16,1996-04-30
9706522,1,1,0,0.0,1.519215213089368e-16,1997-06-27
9707345,1,1,0,0.0,1.519215213089368e-16,1997-07-14
9707464,1,1,0,0.0,1.519215213089368e-16,1997-07-25
9801442,1,1,0,0.0,1.519215213089368e-16,1998-01-29
9802290,1,1,0,0.0,1.519215213089368e-16,1998-02-10
9808455,1,1,0,0.0,1.519215213089368e-16,1998-08-28
9810253,1,1,0,0.0,1.519215213089368e-16,1998-10-05
9812277,1,1,0,0.0,1.519215213089368e-16,1998-12-08
9902481,1,1,0,0.0,1.519215213089368e-16,1999-02-26
9908464,1,1,0,0.0,1.519215213089368e-16,1999-08-25
9912486,1,1,0,0.0,1.519215213089368e-16,1999-12-23
9909233,1,0,1,0.0,8.211974124807393e-20,1999-09-02
9812244,1,0,1,0.0,8.211974124807393e-20,1998-12-03
9910404,1,0,1,0.0,8.211974124807393e-20,1999-10-19
9903346,1,0,1,0.0,8.211974124807393e-20,1999-03-15
111285,1,0,1,0.0,8.211974124807393e-20,2001-11-22
7310,1,0,1,0.0,8.211974124807393e-20,2000-07-27
105164,1,0,1,0.0,8.211974124807393e-20,2001-05-16
103145,1,0,1,0.0,8.211974124807393e-20,2001-03-14
103141,1,0,1,0.0,8.211974124807393e-20,2001-03-13
9610385,1,0,1,0.0,8.211974124807393e-20,1996-10-17
108051,1,0,1,0.0,8.211974124807393e-20,2001-08-06
9611259,1,0,1,0.0,8.211974124807393e-20,1996-11-06
111388,1,0,1,0.0,8.211974124807393e-20,2001-11-29
111189,1,0,1,0.0,8.211974124807393e-20,2001-11-15
9710288,1,0,1,0.0,8.211974124807393e-20,1997-10-08
9293,1,0,1,0.0,8.211974124807393e-20,2000-09-26
9204204,1,1,0,0.0,3.002297740029582e-16,1992-04-02
9206225,1,1,0,0.0,3.002297740029582e-16,1992-06-16
9210233,1,1,0,0.0,3.002297740029582e-16,1992-10-13
9211292,1,1,0,0.0,3.002297740029582e-16,1992-11-20
9302244,1,1,0,0.0,3.002297740029582e-16,1993-02-09
9305258,1,1,0,0.0,3.002297740029582e-16,1993-05-12
9308349,1,1,0,0.0,3.002297740029582e-16,1993-08-27
9401236,1,1,0,0.0,3.002297740029582e-16,1994-01-11
9408351,1,1,0,0.0,3.002297740029582e-16,1994-08-23
9503433,1,1,0,0.0,3.002297740029582e-16,1995-03-24
105167,1,0,1,0.0,8.211974124807393e-20,2001-05-17
9510343,1,0,1,0.0,8.211974124807393e-20,1995-10-19
9512269,1,0,1,0.0,8.211974124807393e-20,1995-12-11
9809240,1,0,1,0.0,8.211974124807393e-20,1998-09-02
105223,1,0,1,0.0,8.211974124807393e-20,2001-05-22
110260,1,0,1,0.0,8.211974124807393e-20,2001-10-18
109237,1,0,1,0.0,8.211974124807393e-20,2001-09-25
104078,1,0,1,0.0,8.211974124807393e-20,2001-04-08
1175,1,1,0,0.0,3.002297740029582e-16,2000-01-18
2033,1,1,0,0.0,3.002297740029582e-16,2000-02-03
7222,1,1,0,0.0,3.002297740029582e-16,2000-07-20
8117,1,1,0,0.0,3.002297740029582e-16,2000-08-11
11092,1,1,0,0.0,3.002297740029582e-16,2000-11-07
103309,1,1,0,0.0,3.002297740029582e-16,2001-03-29
104109,1,1,0,0.0,3.002297740029582e-16,2001-04-11
111124,1,1,0,0.0,3.002297740029582e-16,2001-11-10
112013,1,1,0,0.0,3.002297740029582e-16,2001-12-02
201233,1,1,0,0.0,3.002297740029582e-16,2002-01-24
9312248,1,1,0,0.0,3.002297740029582e-16,1993-12-08
9408359,1,1,0,0.0,3.002297740029582e-16,1994-08-24
9606325,1,1,0,0.0,3.002297740029582e-16,1996-06-13
9706438,1,1,0,0.0,3.002297740029582e-16,1997-06-20
9708481,1,1,0,0.0,3.002297740029582e-16,1997-08-28
9711307,1,1,0,0.0,3.002297740029582e-16,1997-11-12
9801445,1,1,0,0.0,3.002297740029582e-16,1998-01-29
9803210,1,1,0,0.0,3.002297740029582e-16,1998-03-02
9804306,1,1,0,0.0,3.002297740029582e-16,1998-04-16
9806279,1,1,0,0.0,3.002297740029582e-16,1998-06-05
9812236,1,1,0,0.0,3.002297740029582e-16,1998-12-03
9903220,1,1,0,0.0,3.002297740029582e-16,1999-03-01
9905558,1,1,0,0.0,3.002297740029582e-16,1999-05-31
9910416,1,1,0,0.0,3.002297740029582e-16,1999-10-20
9805329,1,0,1,0.0,8.211974124807393e-20,1998-05-14
104187,1,0,1,0.0,8.211974124807393e-20,2001-04-19
201011,1,0,1,0.0,8.211974124807393e-20,2002-01-03
104050,1,0,1,0.0,8.211974124807393e-20,2001-04-04
9805487,1,0,1,0.0,8.211974124807393e-20,1998-05-27
6212,1,0,1,0.0,8.211974124807393e-20,2000-06-19
9601202,1,0,1,0.0,8.211974124807393e-20,1996-01-02
10133,1,1,0,0.0,3.002297740029582e-16,2000-10-13
10334,1,1,0,0.0,3.002297740029582e-16,2000-10-30
101305,1,1,0,0.0,3.002297740029582e-16,2001-01-27
102292,1,1,0,0.0,3.002297740029582e-16,2001-02-23
103047,1,1,0,0.0,3.002297740029582e-16,2001-03-05
105008,1,1,0,0.0,3.002297740029582e-16,2001-05-01
105222,1,1,0,0.0,3.002297740029582e-16,2001-05-22
107124,1,1,0,0.0,3.002297740029582e-16,2001-07-11
108084,1,1,0,0.0,3.002297740029582e-16,2001-08-09
108135,1,1,0,0.0,3.002297740029582e-16,2001-08-16
108242,1,1,0,0.0,3.002297740029582e-16,2001-08-29
109084,1,1,0,0.0,3.002297740029582e-16,2001-09-10
110139,1,1,0,0.0,3.002297740029582e-16,2001-10-10
9304303,1,1,0,0.0,3.002297740029582e-16,1993-04-27
9403274,1,1,0,0.0,3.002297740029582e-16,1994-03-11
9406263,1,1,0,0.0,3.002297740029582e-16,1994-06-09
9406329,1,1,0,0.0,3.002297740029582e-16,1994-06-16
9407338,1,1,0,0.0,3.002297740029582e-16,1994-07-20
9502366,1,1,0,0.0,3.002297740029582e-16,1995-02-22
9606230,1,1,0,0.0,3.002297740029582e-16,1996-06-05
9608480,1,1,0,0.0,3.002297740029582e-16,1996-08-29
9702245,1,1,0,0.0,3.002297740029582e-16,1997-02-04
9702276,1,1,0,0.0,3.002297740029582e-16,1997-02-06
9705254,1,1,0,0.0,3.002297740029582e-16,1997-05-07
9711287,1,1,0,0.0,3.002297740029582e-16,1997-11-11
9801356,1,1,0,0.0,3.002297740029582e-16,1998-01-20
9803454,1,1,0,0.0,3.002297740029582e-16,1998-03-26
9804241,1,1,0,0.0,3.002297740029582e-16,1998-04-06
9805270,1,1,0,0.0,3.002297740029582e-16,1998-05-09
9807421,1,1,0,0.0,3.002297740029582e-16,1998-07-20
9810259,1,1,0,0.0,3.002297740029582e-16,1998-10-06
9811208,1,1,0,0.0,3.002297740029582e-16,1998-11-01
9812205,1,1,0,0.0,3.002297740029582e-16,1998-12-01
9905550,1,1,0,0.0,3.002297740029582e-16,1999-05-30
9906475,1,1,0,0.0,3.002297740029582e-16,1999-06-24
9910238,1,1,0,0.0,3.002297740029582e-16,1999-10-05
9911414,1,1,0,0.0,3.002297740029582e-16,1999-11-19
9911434,1,1,0,0.0,3.002297740029582e-16,1999-11-22
9162,1,0,1,0.0,8.211974124807393e-20,2000-09-14
9904460,1,0,1,0.0,8.211974124807393e-20,1999-04-27
112159,1,0,1,0.0,8.211974124807393e-20,2001-12-11
4048,1,1,0,0.0,4.485380266969801e-16,2000-04-06
4049,1,1,0,0.0,4.485380266969801e-16,2000-04-06
10231,1,1,0,0.0,4.485380266969801e-16,2000-10-19
10240,1,1,0,0.0,4.485380266969801e-16,2000-10-20
11306,1,1,0,0.0,4.485380266969801e-16,2000-11-24
11375,1,1,0,0.0,4.485380266969801e-16,2000-11-29
105159,1,1,0,0.0,4.485380266969801e-16,2001-05-16
105196,1,1,0,0.0,4.485380266969801e-16,2001-05-18
106149,1,1,0,0.0,4.485380266969801e-16,2001-06-14
108043,1,1,0,0.0,4.485380266969801e-16,2001-08-04
108193,1,1,0,0.0,4.485380266969801e-16,2001-08-23
111137,1,1,0,0.0,4.485380266969801e-16,2000-01-09
111137,1,1,0,0.0,4.485380266969801e-16,2001-11-12
111138,1,1,0,0.0,4.485380266969801e-16,2001-11-12
111199,1,1,0,0.0,4.485380266969801e-16,2001-11-15
111224,1,1,0,0.0,4.485380266969801e-16,2001-11-19
112060,1,1,0,0.0,4.485380266969801e-16,2001-12-04
112125,1,1,0,0.0,4.485380266969801e-16,2001-12-09
112310,1,1,0,0.0,4.485380266969801e-16,2001-12-21
112329,1,1,0,0.0,4.485380266969801e-16,2001-12-26
201290,1,1,0,0.0,4.485380266969801e-16,2002-01-30
202048,1,1,0,0.0,4.485380266969801e-16,2002-02-06
202145,1,1,0,0.0,4.485380266969801e-16,2002-02-15
202158,1,1,0,0.0,4.485380266969801e-16,2002-02-18
9506221,1,1,0,0.0,4.485380266969801e-16,1995-06-02
9602395,1,1,0,0.0,4.485380266969801e-16,1996-02-26
9605301,1,1,0,0.0,4.485380266969801e-16,1996-05-14
9606445,1,1,0,0.0,4.485380266969801e-16,1996-06-26
9706309,1,1,0,0.0,4.485380266969801e-16,1997-06-10
9707398,1,1,0,0.0,4.485380266969801e-16,1997-07-19
9711424,1,1,0,0.0,4.485380266969801e-16,1997-11-21
9803305,1,1,0,0.0,4.485380266969801e-16,1998-03-11
9805311,1,1,0,0.0,4.485380266969801e-16,1998-05-13
9809524,1,1,0,0.0,4.485380266969801e-16,1998-09-24
9901350,1,1,0,0.0,4.485380266969801e-16,1999-01-19
9904248,1,1,0,0.0,4.485380266969801e-16,1999-04-06
9907423,1,1,0,0.0,4.485380266969801e-16,1999-07-19
9909355,1,1,0,0.0,4.485380266969801e-16,1999-09-14
9909390,1,1,0,0.0,4.485380266969801e-16,1999-09-15
108012,1,0,1,0.0,8.211974124807393e-20,2001-08-02
9903347,1,0,1,0.0,8.211974124807393e-20,1999-03-15
9402236,1,1,0,0.0,7.7767394961926e-17,1994-02-07
9405425,1,1,0,0.0,7.7767394961926e-17,1994-05-31
9411367,1,1,0,0.0,7.7767394961926e-17,1994-11-23
9412355,1,1,0,0.0,7.7767394961926e-17,1994-12-22
9503477,1,1,0,0.0,7.7767394961926e-17,1995-03-30
9506264,1,1,0,0.0,7.7767394961926e-17,1995-06-06
9506332,1,1,0,0.0,7.7767394961926e-17,1995-06-15
9507449,1,1,0,0.0,7.7767394961926e-17,1995-07-28
9601206,1,1,0,0.0,7.7767394961926e-17,1996-01-03
9606219,1,1,0,0.0,7.7767394961926e-17,1996-06-04
9609305,1,1,0,0.0,7.7767394961926e-17,1996-09-10
9609308,1,1,0,0.0,7.7767394961926e-17,1996-09-10
9703383,1,1,0,0.0,7.7767394961926e-17,1997-03-21
9710323,1,1,0,0.0,7.7767394961926e-17,1997-10-13
9712247,1,1,0,0.0,7.7767394961926e-17,1997-12-03
9911427,1,1,0,0.0,7.7767394961926e-17,1999-11-22
9507412,1,0,1,0.0,8.211974124807393e-20,1995-07-25
9907223,1,0,1,0.0,8.211974124807393e-20,1999-07-05
202080,1,0,1,0.0,8.211974124807393e-20,2002-02-08
202259,1,0,1,0.0,8.211974124807393e-20,2002-02-27
9609508,1,0,1,0.0,8.211974124807393e-20,1996-09-27
110188,1,0,1,0.0,8.211974124807393e-20,2001-10-15
111198,1,0,1,0.0,8.211974124807393e-20,2001-11-15
11068,1,0,1,0.0,8.211974124807393e-20,2000-11-06
109040,1,0,1,0.0,8.211974124807393e-20,2001-09-05
201095,1,0,1,0.0,8.211974124807393e-20,2002-01-11
9910245,1,0,1,0.0,8.211974124807393e-20,1999-10-05
9906528,1,0,1,0.0,8.211974124807393e-20,1999-06-29
5087,1,0,1,0.0,8.211974124807393e-20,2000-05-10
110183,1,0,1,0.0,8.211974124807393e-20,2001-10-15
9209205,1,1,0,0.0,1.519215213089368e-16,1992-09-02
9305319,1,1,0,0.0,1.519215213089368e-16,1993-05-26
9309289,1,1,0,0.0,1.519215213089368e-16,1993-09-19
9310257,1,1,0,0.0,1.519215213089368e-16,1993-10-11
9311205,1,1,0,0.0,1.519215213089368e-16,1993-11-01
9402335,1,1,0,0.0,1.519215213089368e-16,1994-02-22
9403256,1,1,0,0.0,1.519215213089368e-16,1994-03-09
9408245,1,1,0,0.0,1.519215213089368e-16,1994-08-05
9502289,1,1,0,0.0,1.519215213089368e-16,1995-02-13
9505320,1,1,0,0.0,1.519215213089368e-16,1995-05-16
9508302,1,1,0,0.0,1.519215213089368e-16,1995-08-14
9509353,1,1,0,0.0,1.519215213089368e-16,1995-09-21
9602363,1,1,0,0.0,1.519215213089368e-16,1996-02-21
9604383,1,1,0,0.0,1.519215213089368e-16,1996-04-22
9605446,1,1,0,0.0,1.519215213089368e-16,1996-05-30
9606280,1,1,0,0.0,1.519215213089368e-16,1996-06-09
9606337,1,1,0,0.0,1.519215213089368e-16,1996-06-14
9701229,1,1,0,0.0,1.519215213089368e-16,1997-01-06
9704369,1,1,0,0.0,1.519215213089368e-16,1997-04-21
9706377,1,1,0,0.0,1.519215213089368e-16,1997-06-16
9712301,1,1,0,0.0,1.519215213089368e-16,1997-12-08
9712415,1,1,0,0.0,1.519215213089368e-16,1997-12-17
9712517,1,1,0,0.0,1.519215213089368e-16,1997-12-24
9802440,1,1,0,0.0,1.519215213089368e-16,1998-02-26
9807462,1,1,0,0.0,1.519215213089368e-16,1998-07-22
9807513,1,1,0,0.0,1.519215213089368e-16,1998-07-27
9808257,1,1,0,0.0,1.519215213089368e-16,1998-08-07
9901281,1,1,0,0.0,1.519215213089368e-16,1999-01-12
9901318,1,1,0,0.0,1.519215213089368e-16,1999-01-14
9903358,1,1,0,0.0,1.519215213089368e-16,1999-03-15
9904404,1,1,0,0.0,1.519215213089368e-16,1999-04-20
9907231,1,1,0,0.0,1.519215213089368e-16,1999-07-05
8192,1,0,1,0.0,8.211974124807393e-20,2000-08-18
9901309,1,0,1,0.0,8.211974124807393e-20,1999-01-14
6132,1,0,1,0.0,8.211974124807393e-20,2000-06-13
9187,16,0,16,0.0,8.211974124807393e-20,2000-09-15
7010,1,1,0,0.0,3.613268614915252e-18,2000-07-03
9206242,1,1,0,0.0,3.613268614915252e-18,1992-06-22
9207264,1,1,0,0.0,3.613268614915252e-18,1992-07-27
9212271,1,1,0,0.0,3.613268614915252e-18,1992-12-16
9212284,1,1,0,0.0,3.613268614915252e-18,1992-12-18
9402243,1,1,0,0.0,3.613268614915252e-18,1994-02-07
9411406,1,1,0,0.0,3.613268614915252e-18,1994-11-28
9504274,1,1,0,0.0,3.613268614915252e-18,1995-04-10
9607439,1,1,0,0.0,3.613268614915252e-18,1996-07-26
9808256,1,1,0,0.0,3.613268614915252e-18,1998-08-07
9810512,1,1,0,0.0,3.613268614915252e-18,1998-10-28
9810534,1,1,0,0.0,3.613268614915252e-18,1998-10-29
9902475,1,1,0,0.0,3.613268614915252e-18,1999-02-26
9907553,1,1,0,0.0,3.613268614915252e-18,1999-07-29
9909302,1,1,0,0.0,3.613268614915252e-18,1999-09-09
9910400,1,0,1,0.0,8.211974124807393e-20,1999-10-19
3192,1,0,1,0.0,8.211974124807393e-20,2000-03-20
9205234,1,1,0,0.0,7.7767394961926e-17,1992-05-26
9308365,1,1,0,0.0,7.7767394961926e-17,1993-08-31
9708440,1,1,0,0.0,7.7767394961926e-17,1997-08-22
9708441,1,1,0,0.0,7.7767394961926e-17,1997-08-22
9901301,1,1,0,0.0,7.7767394961926e-17,1999-01-14
111004,1,0,1,0.0,8.211974124807393e-20,2001-10-31
11168,1,0,1,0.0,8.211974124807393e-20,2000-11-13
11153,1,0,1,0.0,8.211974124807393e-20,2000-11-11
6169,1,0,1,0.0,8.211974124807393e-20,2000-06-15
5307,1,0,1,0.0,8.211974124807393e-20,2000-05-30
105018,1,0,1,0.0,8.211974124807393e-20,2001-05-02
103232,1,0,1,0.0,8.211974124807393e-20,2001-03-21
108183,1,0,1,0.0,8.211974124807393e-20,2001-08-22
107033,1,0,1,0.0,8.211974124807393e-20,2001-07-04
9809359,1,0,1,0.0,8.211974124807393e-20,1998-09-13
112201,1,0,1,0.0,8.211974124807393e-20,2001-12-14
9605396,1,0,1,0.0,8.211974124807393e-20,1996-05-24
201218,1,0,1,0.0,8.211974124807393e-20,2002-01-23
9806330,1,0,1,0.0,8.211974124807393e-20,1998-06-10
9904503,1,0,1,0.0,8.211974124807393e-20,1999-04-30
9712472,1,0,1,0.0,8.211974124807393e-20,1997-12-21
9505225,1,1,0,0.0,7.7767394961926e-17,1995-05-03
9604313,1,1,0,0.0,7.7767394961926e-17,1996-04-13
9611272,1,1,0,0.0,7.7767394961926e-17,1996-11-07
9705234,1,1,0,0.0,7.7767394961926e-17,1997-05-05
9705240,1,1,0,0.0,7.7767394961926e-17,1997-05-06
10011,1,0,1,0.0,8.211974124807393e-20,2000-10-02
2065,1,1,0,0.0,3.613268614915252e-18,2000-02-06
8114,1,1,0,0.0,3.613268614915252e-18,2000-08-11
101248,1,1,0,0.0,3.613268614915252e-18,2001-01-22
102005,1,1,0,0.0,3.613268614915252e-18,2001-02-01
110238,1,1,0,0.0,3.613268614915252e-18,2001-10-17
111127,1,1,0,0.0,3.613268614915252e-18,2001-11-10
111340,1,1,0,0.0,3.613268614915252e-18,2001-11-27
9305321,1,1,0,0.0,3.613268614915252e-18,1993-05-26
9310210,1,1,0,0.0,3.613268614915252e-18,1993-10-01
9311284,1,1,0,0.0,3.613268614915252e-18,1993-11-12
9312212,1,1,0,0.0,3.613268614915252e-18,1993-12-02
9410385,1,1,0,0.0,3.613268614915252e-18,1994-10-26
9412319,1,1,0,0.0,3.613268614915252e-18,1994-12-19
9503311,1,1,0,0.0,3.613268614915252e-18,1995-03-13
9503344,1,1,0,0.0,3.613268614915252e-18,1995-03-15
9504256,2,2,0,0.0,7.144417488582434e-18,1995-04-07
9507265,1,1,0,0.0,3.613268614915252e-18,1995-07-08
9512434,1,1,0,0.0,3.613268614915252e-18,1995-12-27
9606274,1,1,0,0.0,3.613268614915252e-18,1996-06-07
9606381,1,1,0,0.0,3.613268614915252e-18,1996-06-19
9607451,1,1,0,0.0,3.613268614915252e-18,1996-07-27
9611341,1,1,0,0.0,3.613268614915252e-18,1996-11-16
9611434,1,1,0,0.0,3.613268614915252e-18,1996-11-26
9702393,1,1,0,0.0,3.613268614915252e-18,1997-02-21
9710380,1,1,0,0.0,3.613268614915252e-18,1997-10-16
9804309,1,1,0,0.0,3.613268614915252e-18,1998-04-17
9912336,1,1,0,0.0,3.613268614915252e-18,1999-12-14
9912338,1,1,0,0.0,3.613268614915252e-18,1999-12-14
104046,1,0,1,0.0,8.211974124807393e-20,2001-04-04
9907448,1,0,1,0.0,8.211974124807393e-20,1999-07-21
9706393,1,0,1,0.0,8.211974124807393e-20,1997-06-17
3219,1,1,0,0.0,3.613268614915252e-18,2000-03-22
105144,1,1,0,0.0,3.613268614915252e-18,2001-05-15
109042,1,1,0,0.0,3.613268614915252e-18,2001-09-05
201224,1,1,0,0.0,3.613268614915252e-18,2002-01-23
201226,1,1,0,0.0,3.613268614915252e-18,2002-01-23
201262,1,1,0,0.0,3.613268614915252e-18,2002-01-28
201307,1,1,0,0.0,3.613268614915252e-18,2002-01-31
202003,1,1,0,0.0,3.613268614915252e-18,2002-02-01
202006,1,1,0,0.0,3.613268614915252e-18,2002-02-01
202034,1,1,0,0.0,3.613268614915252e-18,2002-02-05
202143,1,1,0,0.0,3.613268614915252e-18,2002-02-15
202147,1,1,0,0.0,3.613268614915252e-18,2002-02-15
202247,1,1,0,0.0,3.613268614915252e-18,2002-02-26
202262,1,1,0,0.0,3.613268614915252e-18,2002-02-27
203051,1,1,0,0.0,3.613268614915252e-18,2002-03-05
9502315,1,1,0,0.0,3.613268614915252e-18,1995-02-16
9502385,1,1,0,0.0,3.613268614915252e-18,1995-02-24
9612357,1,1,0,0.0,3.613268614915252e-18,1996-12-13
9701253,1,1,0,0.0,3.613268614915252e-18,1997-01-09
9703464,1,1,0,0.0,3.613268614915252e-18,1997-03-31
9707207,1,1,0,0.0,3.613268614915252e-18,1997-07-01
9712535,1,1,0,0.0,3.613268614915252e-18,1997-12-29
9803253,1,1,0,0.0,3.613268614915252e-18,1998-03-05
9902340,1,1,0,0.0,3.613268614915252e-18,1999-02-15
9905509,1,1,0,0.0,3.613268614915252e-18,1999-05-27
9907234,1,1,0,0.0,3.613268614915252e-18,1999-07-05
7077,1,0,1,0.0,8.211974124807393e-20,2000-07-08
9701377,1,0,1,0.0,8.211974124807393e-20,1997-01-24
9908471,1,0,1,0.0,8.211974124807393e-20,1999-08-26
2025,1,0,1,0.0,8.211974124807393e-20,2000-02-02
9046,1,0,1,0.0,8.211974124807393e-20,2000-09-05
9912541,1,0,1,0.0,8.211974124807393e-20,1999-12-29
8167,1,0,1,0.0,8.211974124807393e-20,2000-08-16
9608489,1,0,1,0.0,8.211974124807393e-20,1996-08-29
12093,1,0,1,0.0,8.211974124807393e-20,2000-12-08
6252,1,0,1,0.0,8.211974124807393e-20,2000-06-21
111008,1,0,1,0.0,8.211974124807393e-20,2001-11-01
12316,1,0,1,0.0,8.211974124807393e-20,2000-12-22
105178,2,0,2,0.0,8.211974124807393e-20,2001-05-17
1235,1,0,1,0.0,8.211974124807393e-20,2000-01-24
101073,1,0,1,0.0,8.211974124807393e-20,2001-01-09
9812374,1,0,1,0.0,8.211974124807393e-20,1998-12-15
108200,1,0,1,0.0,8.211974124807393e-20,2001-08-23
9607235,1,0,1,0.0,8.211974124807393e-20,1996-07-04
2031,1,0,1,0.0,8.211974124807393e-20,2000-02-02
9907247,45,0,45,0.0,8.211974124807393e-20,1999-07-06
9303251,1,1,0,0.0,3.613268614915252e-18,1993-03-12
9403403,1,1,0,0.0,3.613268614915252e-18,1994-03-30
9404292,1,1,0,0.0,3.613268614915252e-18,1994-04-19
9405424,1,1,0,0.0,3.613268614915252e-18,1994-05-31
9406285,1,1,0,0.0,3.613268614915252e-18,1994-06-10
9408262,1,1,0,0.0,3.613268614915252e-18,1994-08-10
9409434,1,1,0,0.0,3.613268614915252e-18,1994-09-28
9410218,1,1,0,0.0,3.613268614915252e-18,1994-10-04
9411334,1,1,0,0.0,3.613268614915252e-18,1994-11-18
9502313,1,1,0,0.0,3.613268614915252e-18,1995-02-16
9508280,1,1,0,0.0,3.613268614915252e-18,1995-08-10
9508379,1,1,0,0.0,3.613268614915252e-18,1995-08-27
9508406,1,1,0,0.0,3.613268614915252e-18,1995-08-30
9603208,1,1,0,0.0,3.613268614915252e-18,1996-03-01
9605214,1,1,0,0.0,3.613268614915252e-18,1996-05-02
9605288,1,1,0,0.0,3.613268614915252e-18,1996-05-12
9612286,1,1,0,0.0,3.613268614915252e-18,1996-12-08
9612291,1,1,0,0.0,3.613268614915252e-18,1996-12-08
9702376,1,1,0,0.0,3.613268614915252e-18,1997-02-20
9703414,1,1,0,0.0,3.613268614915252e-18,1997-03-25
9704360,1,1,0,0.0,3.613268614915252e-18,1997-04-20
9704416,1,1,0,0.0,3.613268614915252e-18,1997-04-28
9708207,1,1,0,0.0,3.613268614915252e-18,1997-08-01
9710463,1,1,0,0.0,3.613268614915252e-18,1997-10-24
9711263,1,1,0,0.0,3.613268614915252e-18,1997-11-08
9801333,1,1,0,0.0,3.613268614915252e-18,1998-01-17
9804460,1,1,0,0.0,3.613268614915252e-18,1998-04-30
9805215,1,1,0,0.0,3.613268614915252e-18,1998-05-04
9809291,1,1,0,0.0,3.613268614915252e-18,1998-09-07
9811513,1,1,0,0.0,3.613268614915252e-18,1998-11-30
9902373,1,1,0,0.0,3.613268614915252e-18,1999-02-17
9902376,1,1,0,0.0,3.613268614915252e-18,1999-02-17
9903513,1,1,0,0.0,3.613268614915252e-18,1999-03-29
9905269,1,1,0,0.0,3.613268614915252e-18,1999-05-07
9905337,1,1,0,0.0,3.613268614915252e-18,1999-05-14
111119,1,0,1,0.0,8.211974124807393e-20,2001-11-09
9912348,1,0,1,0.0,8.211974124807393e-20,1999-12-15
9084,1,0,1,0.0,8.211974124807393e-20,2000-09-07
9710527,13,0,13,0.0,8.211974124807393e-20,1997-10-29
9311260,1,1,0,0.0,3.613268614915252e-18,1993-11-10
9507363,1,1,0,0.0,3.613268614915252e-18,1995-07-20
9604351,1,1,0,0.0,3.613268614915252e-18,1996-04-18
9702225,1,1,0,0.0,3.613268614915252e-18,1997-02-03
9702389,1,1,0,0.0,3.613268614915252e-18,1997-02-21
9703429,1,1,0,0.0,3.613268614915252e-18,1997-03-26
9706374,1,1,0,0.0,3.613268614915252e-18,1997-06-16
9506337,1,0,1,0.0,8.211974124807393e-20,1995-06-15
5137,1,0,1,0.0,8.211974124807393e-20,2000-05-15
9802339,1,0,1,0.0,8.211974124807393e-20,1998-02-17
